AA级绿色食品	饮食
AD奶	饮食
Amovo巧克力	饮食
ampo	饮食
At.Mospher	饮食
《阿鸿食游记》	饮食
BBQ烤牛肋骨	饮食
BoBo烤肉牛扒馆	饮食
BRUUMLMEUR	饮食
《便秘吃什么》	饮食
《别让营养误了孩子未	饮食
不安全食品	饮食
不差钱农家菜馆	饮食
不良饮食习惯	饮食
不醉茶	饮食
Capital M	饮食
CASTELLA蛋糕	饮食
Chendol	饮食
Coca Cola	饮食
COURVOISIE	饮食
参麦糖梨	饮食
《厨师之旅》	饮食
炒大白菜	饮食
《吃主儿》	饮食
《吃好比好吃更重要》	饮食
《吃对了就能大大提高	饮食
《吃心不改》	饮食
《吃来吃去》	饮食
《吃的历史》	饮食
《此味只应天上有》	饮食
《炒鸭肠》	饮食
《炒鹌鹑》	饮食
吃播经济	饮食
《超Q润戚风》	饮食
《餐中随意下饭菜》	饮食
丑鱼美味清蒸鸦片鱼头	饮食
串串香	饮食
串丸子	饮食
串炸牛仔	饮食
串炸里脊	饮食
串烤比目鱼	饮食
串烤海鲜	饮食
串烤肉	饮食
串烤鲜鱿菌	饮食
串烧三明治	饮食
串烧便当	饮食
串烧土司三明治	饮食
串烧扇贝肉	饮食
串烧排骨	饮食
串烧海鲜	饮食
串烧鲟鱼	饮食
串烧鸡柳	饮食
串烧黄鳝	饮食
串煎沙嗲	饮食
串煎馄饨	饮食
串肉意大利面	饮食
DASH饮食	饮食
DEHP毒饮料	饮食
DF冰淇淋	饮食
大骨豆芽汤	饮食
豆浆机做米糊	饮食
《点食成金》	饮食
豆豉	饮食
丁丁辣子鸡	饮食
丁字麸	饮食
丁当鸡	饮食
丁香可乐酱猪蹄	饮食
丁香姜糖	饮食
丁香小鱼	饮食
丁香拌油条	饮食
丁香排骨	饮食
丁香火锅	饮食
丁香炒鱼干	饮食
丁香焖鸭	饮食
丁香肉丝	饮食
丁香肉桂鸭汤	饮食
丁香落地	饮食
丁香虾仁	饮食
丁香野兔肉	饮食
丁香野鸭	饮食
丁香雪梨汤	饮食
丁香鱼南蛮渍	饮食
丁香鱼炒咸菜	饮食
丁香鱼焗蝴蝶面	饮食
丁香鱼饺	饮食
丁香鸭	饮食
丁香鸭子	饮食
东京式厨房	饮食
东京荞麦面	饮食
东京蛋卷寿司	饮食
东京鸡肉卷	饮食
东八区茶餐厅	饮食
东北乱炖	饮食
东北凉拌菜	饮食
东北家常锅包肉	饮食
东北小炒皇	饮食
东北拉皮	饮食
东北焖子	饮食
东北熏干豆腐肉卷	饮食
东北猪肉皮冻	饮食
东北玻璃叶饼	饮食
东北粘豆包	饮食
东北肘子	饮食
东北芥梗	饮食
东北菜	饮食
东北菜芹菜鱼丝	饮食
东北蘸酱菜	饮食
东北虎鑫菜馆	饮食
东北酸菜	饮食
东北食文化	饮食
东北饭包	饮食
东北龙胆	饮食
东华乍	饮食
东南亚鸡肉沙拉	饮食
东园家酒	饮食
东坞山豆腐皮	饮食
东坡墨鱼	饮食
东坡扣肉	饮食
东坡春鸠脍	饮食
东坡烧梅	饮食
东坡牛脯	饮食
东坡狗肉	饮食
东坡糖蒸肉	饮食
东坡肉	饮食
东坡肉泰式炒饭	饮食
东坡肘	饮食
东坡肘子	饮食
东坡腊乳狗	饮食
东坡茄子	饮食
东坡茄子煲	饮食
东坡茶	饮食
东坡蒸猪头	饮食
东坡蜜酒	饮食
东坡豆粥	饮食
东坡酒	饮食
东坡饺	饮食
东坡饼	饮食
东坡鳊鱼	饮食
东壁龙珠	饮食
东安子鸡	饮食
东安鸡	饮食
东尼窖藏莎当妮干白	饮食
东尼至尊赤霞珠干红葡	饮食
东尼赤霞珠干红葡萄酒	饮食
东平烧饼	饮食
东方市师鸡	饮食
东方式子脑浓汤	饮食
东方美人茶	饮食
东星绉纱鱼卷	饮食
东来葱煎饼	饮食
东来顺	饮食
东江东坡宴	饮食
东江卤肉	饮食
东江牛肉丸	饮食
东江瓤豆腐	饮食
东江盐h鸡	饮食
东江盐浸鸡	饮食
东江盐烙鸡	饮食
东江盐焗鸡	饮食
东江菜	饮食
东江豆腐煲	饮食
东江酿豆腐	饮食
东江鱼丸	饮食
东海夫人炖猪手	饮食
东璧龙珠	饮食
东瓜水晶葡萄	饮食
东白春芽茶	饮食
东莞兴荣膳食管理服务	饮食
东莞富盈酒店	饮食
东菱豆浆机	饮食
东营南国风情生态园	饮食
东营大闸蟹	饮食
东阳千祥羊肉	饮食
东阳土鸡煲	饮食
东阳索粉	饮食
丹参桃仁炖鳖鱼	饮食
丹参海蜇煲	饮食
edamame	饮食
E族皇后奶茶	饮食
Food and B	饮食
方便面锅	饮食
《凤尾虾排》	饮食
《非常美食》	饮食
《风行欧罗巴》	饮食
丰化摇蚶	饮食
丰化芋艿头	饮食
丰年灌肠	饮食
丰收玉米	饮食
丰收的果园	饮食
丰收硕果	饮食
丰收秋实	饮食
丰收葡萄酒	饮食
丰收鱼虹	饮食
丰收龙舟	饮食
丰泽园字号	饮食
丰胸美容汤	饮食
丰胸通草汤	饮食
GMO	饮食
个性月饼	饮食
胡子鱼	饮食
《哈佛医学院育儿营养	饮食
《好利来》	饮食
《海派名菜名点》	饮食
《红楼梦》与酒文化	饮食
《胡吃乱想》	饮食
海鲜码头	饮食
《黄帝内经——对症食	饮食
iKitchen	饮食
IPAD点菜	饮食
iPhone饼干	饮食
假饥饿	饮食
《健康宝库茶与健康》	饮食
《健康饮食手书》	饮食
《极致之味：怡兰的1	饮食
《椒盐八宝鸡》	饮食
《煎酿三宝》	饮食
《金酒鸡尾酒袖珍手册	饮食
KFC甜玉米沙拉	饮食
KFC黄金蝴蝶虾	饮食
Kiviak	饮食
L-阿拉伯糖	饮食
La Zebra餐厅	饮食
Le Tobsil餐	饮食
Le Whif	饮食
long	饮食
lozzi	饮食
《旅游世界》	饮食
两吃于贝	饮食
两吃多宝鱼	饮食
两吃大乌鱼	饮食
两吃毛豆	饮食
两吃活虾	饮食
两吃菠菜	饮食
两吃鳜鱼	饮食
两味绿豆汤	饮食
两彩大虾	饮食
两情相悦	饮食
两掺	饮食
两炸豆腐	饮食
两相好	饮食
两虾豆腐	饮食
两香问政山笋	饮食
临刑餐	饮食
临汝药酒	饮食
临沂糁	饮食
临泉粉丝	饮食
临海麦饼	饮食
临淄特色小吃	饮食
临潼醪糟	饮食
临猗酱玉瓜	饮食
临高乳猪	饮食
MARSALA酒	饮食
Merchandis	饮食
Mexican Pu	饮食
Mezzomix	饮食
《梅花粥》	饮食
《美凤有约》	饮食
《美国人饮食指南》	饮食
《美食成都》	饮食
麻辣鸭头	饮食
《蜜蜂产品生产管理规	饮食
《面包新语》	饮食
《你所不知道的葡萄酒	饮食
浓汁盖鱼	饮食
PapaRoti	饮食
PITA口袋饼	饮食
Ponta	饮食
poussin	饮食
POV	饮食
QQ的甜甜圈	饮食
茄子皮蛋	饮食
《轻松调饮养生保健花	饮食
七喜冰凉瓜	饮食
七姐妹酒	饮食
七子饼茶	饮食
七宝供水站	饮食
七宝祛斑饮	饮食
七彩什锦煲	饮食
七彩什锦砂锅	饮食
七彩冻鸭丝	饮食
七彩判扬	饮食
七彩双菇	饮食
七彩干贝汤	饮食
七彩日本冷面	饮食
七彩杂锦煲	饮食
七彩炒肝尖	饮食
七彩炒鲟皮	饮食
七彩烩胗芹	饮食
七彩瓤猪肚	饮食
七彩粉丝赠粉丝	饮食
七彩粥	饮食
七彩粿汁糕	饮食
七彩菊花桂鱼柳	饮食
七彩豆腐	饮食
七彩金盏	饮食
七彩鱼生	饮食
七彩鲑鱼	饮食
七彩鸡丝	饮食
七彩鹿肉面	饮食
七星丸	饮食
七星拼盘	饮食
七星紫蟹	饮食
七星葫芦鸭	饮食
七星螃蟹	饮食
七星鱼丸	饮食
七星鱼丸汤	饮食
七样止渴汤	饮食
七粮液	饮食
《Redbook生活	饮食
Samtaesung	饮食
Scarlett红酒	饮食
Smith Wol	饮食
《上海的吃》	饮食
《世界葡萄酒全书》	饮食
《是议全书》	饮食
《桑葚粥》	饮食
《深层素食主义》	饮食
《生活大参考》	饮食
《瘦身食谱》	饮食
《素食杂谈》	饮食
《舌尖上的中国》	饮食
《苏GOOD》	饮食
《食品真相大揭秘》	饮食
《食得健康》	饮食
三A红提子露酒	饮食
三丁包	饮食
三丁大包	饮食
三丁炒松子	饮食
三丁炒玉米	饮食
三丁炒腰果	饮食
三丁炒饭	饮食
三丁烩白云	饮食
三丁烩虾仁	饮食
三丁玉米	饮食
三丁茭白	饮食
三丁酥合	饮食
三丁野菜	饮食
三七乌骨鸡	饮食
三七全鸡汤	饮食
三七灵芝	饮食
三七蒸鸡	饮食
三七藕蛋汤	饮食
三七蜂蜜核桃茶	饮食
三不粘	饮食
三丝丸子	饮食
三丝南菜	饮食
三丝发菜羹	饮食
三丝干巴菌	饮食
三丝年糕	饮食
三丝扒茄合	饮食
三丝拌洋菜	饮食
三丝拌粉皮	饮食
三丝拌糟鸡	饮食
三丝拌蛏	饮食
三丝拌金针	饮食
三丝汤	饮食
三丝河粉卷	饮食
三丝清炒蟹	饮食
三丝炒蛋	饮食
三丝炒鸽松	饮食
三丝炝花枝	饮食
三丝燕菜	饮食
三丝牛肉卷	饮食
三丝白菜汤	饮食
三丝百灵菇	饮食
三丝眉毛酥	饮食
三丝糊塌子	饮食
三丝素鱼翅	饮食
三丝紫菜汤	饮食
三丝羹	饮食
三丝荞麦凉面	饮食
三丝荷包蛋	饮食
三丝蒸大鳝	饮食
三丝豆苗汤	饮食
三丝银鱼羹	饮食
三丝鱼翅	饮食
三丝鱿鱼	饮食
三丝鲜鱼	饮食
三丝黄花菜	饮食
三丝龙袍	饮食
三个贵州人	饮食
三么台	饮食
三乌鸡	饮食
三人行西餐厅	饮食
三仁龙虾球	饮食
三仙通草汤	饮食
三仙酿上海青	饮食
三元八宝乳鸽	饮食
三元汤	饮食
三元甲鱼	饮食
三全凌汤圆	饮食
三冬汤	饮食
三刀	饮食
三原蓼花糖	饮食
三叶草面包	饮食
三合一咖啡	饮食
三合油香椿面	饮食
三合泥	饮食
三合鱼腥茶	饮食
三味养颜茶	饮食
三味南瓜鸡	饮食
三味拌黄瓜	饮食
三味汤	饮食
三味灯笼虾	饮食
三味炖大鹅	饮食
三味牡丹鱼	饮食
三味玉翡翠	饮食
三味白菜	饮食
三味肠饼	饮食
三味蒸回鱼	饮食
三味蒸鮰鱼	饮食
三味薏米羹	饮食
三味豆腐	饮食
三味锅	饮食
三味黄瓜	饮食
三圆扒海参	饮食
三夏红柿香菇炒肉	饮食
三奇肉	饮食
三套碗	饮食
三套鸭	饮食
三子炖猪腰汤	饮食
三宝汤	饮食
三宝炖仔鸭	饮食
三宝粳米粥	饮食
三宝芙蓉蛋	饮食
三宝酱虾炒西洋菜	饮食
三宝饭便当	饮食
三宝鲍片	饮食
三宝鲜汤	饮食
三层套鸡	饮食
三层色酒杯冻	饮食
三峡龙井	饮食
三彩大虾	饮食
三彩脆皮豆腐	饮食
三彩菠菜	饮食
三才鲜鸡汤	饮食
三文一品汤包	饮食
三文翡翠卷	饮食
三文鱼北极贝鲜虾寿司	饮食
三文鱼圆海带汤	饮食
三文鱼土司卷	饮食
三文鱼头浓汤	饮食
三文鱼木斯丸	饮食
三文鱼沙拉	饮食
三文鱼沙拉卷	饮食
三文鱼炒三丁	饮食
三文鱼生鱼片沙拉	饮食
三文鱼腰果豆腐羹	饮食
三文鱼蒸肉饼	饮食
三文鱼蒸蛋羹	饮食
三文鱼薄饼匹萨	饮食
三文鱼蘑菇汤面	饮食
三文鱼酸奶莳萝酱	饮食
三文鱼醪糟蛋羹	饮食
三文鱼青木瓜沙律	饮食
三文鱼馅饺子	饮食
三文鱼鲜蔬沙拉	饮食
三星麻团	饮食
三杯啤酒鸭	饮食
三杯开屏鱼	饮食
三杯田鸡	饮食
三杯甲鱼	饮食
三杯素鸭	饮食
三杯蒜香虾	饮食
三杯豆腐	饮食
三杯酱瓜	饮食
三杯面轮	饮食
三杯香茶	饮食
三杯鳗鱼	饮食
三杯鸡翼	饮食
三杯鸭	饮食
三林糖酱瓜	饮食
三果美体汁	饮食
三果营养汁	饮食
三果蜜汁	饮食
三样汤	饮食
三椒会脍	饮食
三椒小肥羊	饮食
三椒戏牛尾	饮食
三椒魔芋啤酒鸡	饮食
三汁闷锅	饮食
三沙粿仔	饮食
三河米饺	饮食
三油浸鱼	饮食
三煲乳鸽	饮食
三熟鱼汤	饮食
三片汤	饮食
三物汤	饮食
三珍蟹黄羹	饮食
三瓜瑶柱羹	饮食
三皮丝	饮食
三稔煲荠菜	饮食
三精水	饮食
三美豆腐	饮食
三聚氰胺鸡蛋	饮食
三般茶	饮食
三色冰淇淋	饮食
三色凉面	饮食
三色凤尾虾	饮食
三色印字饼干	饮食
三色口蘑	饮食
三色圈饼	饮食
三色小蛋卷	饮食
三色布丁	饮食
三色布丁杯	饮食
三色披萨	饮食
三色拉花干点	饮食
三色拨鱼儿	饮食
三色明虾片	饮食
三色杂烩粥	饮食
三色杏仁	饮食
三色杏鲍菇	饮食
三色果冻	饮食
三色果汁	饮食
三色桂花汤圆	饮食
三色椒百香果泡菜	饮食
三色水晶包	饮食
三色水果冰	饮食
三色沙虫	饮食
三色炒百合	饮食
三色炸椒	饮食
三色煎蛋	饮食
三色爆肚片	饮食
三色猫耳朵	饮食
三色玉米	饮食
三色甜汤	饮食
三色百叶	饮食
三色糕	饮食
三色羹	饮食
三色肉丸	饮食
三色肝末	饮食
三色芝麻汤圆	饮食
三色花心卷	饮食
三色菊花丝	饮食
三色萝卜丝	饮食
三色萝卜炖牛肉	饮食
三色蒸糕	饮食
三色蒸蛋	饮食
三色蔬菜	饮食
三色蛋	饮食
三色蛋餐盒	饮食
三色豆腐渣	饮食
三色豆芽	饮食
三色酿大芥菜	饮食
三色野生斑	饮食
三色青菜包	饮食
三色鱼丸汤	饮食
三色鱼条	饮食
三色鸡	饮食
三色鸡丁	饮食
三色鸡鱼丸	饮食
三色鸵鸟蛋饼	饮食
三色龙虾	饮食
三花头艳	饮食
三花茶	饮食
三花鱼肚	饮食
三花龙眼茶	饮食
三草养颜汤	饮食
三菇发菜	饮食
三菇浸鱼云	饮食
三菇炒伊面	饮食
三菇炖鱼头	饮食
三菇牛骨髓	饮食
三菇献寿	饮食
三菇猴头	饮食
三菇腐皮云耳蒸牛肝	饮食
三菇菜心	饮食
三菇鲜汤	饮食
三菌炖鸡	饮食
三葱焖排骨	饮食
三蔬蛤蜊汤	饮食
三虾豆腐	饮食
三蛇羹	饮食
三蛇蛤蚧酒	饮食
三衣银耳汤补体液	饮食
三角豆沙包	饮食
三角豆腐	饮食
三角豆腐饺	饮食
三豆炆节瓜	饮食
三豆白鸭汤	饮食
三酱猪肠粉	饮食
三雪蚌花瘦肉汤	饮食
三页饼	饮食
三餐饮食原则	饮食
三香包子	饮食
三香辣椒	饮食
三驱田凉粉	饮食
三鲜	饮食
三鲜仙人菇	饮食
三鲜冬瓜	饮食
三鲜冰豆腐	饮食
三鲜包子	饮食
三鲜参片汤	饮食
三鲜土豆粉煲	饮食
三鲜小馄饨	饮食
三鲜打卤面	饮食
三鲜拌豆腐	饮食
三鲜水饺	饮食
三鲜汁	饮食
三鲜汤饺	饮食
三鲜沙锅	饮食
三鲜火锅	饮食
三鲜炒芦笋	饮食
三鲜炒蕨菜	饮食
三鲜烙盒	饮食
三鲜烧真胗	饮食
三鲜烩拉皮	饮食
三鲜烩鱼唇	饮食
三鲜猴头菇	饮食
三鲜玉米团	饮食
三鲜玉米羹	饮食
三鲜珍珠丸	饮食
三鲜瑶柱	饮食
三鲜砂锅	饮食
三鲜竹筒箜鱼皮饺	饮食
三鲜竹荪	饮食
三鲜素海参	饮食
三鲜素肉块	饮食
三鲜素鱼肚	饮食
三鲜绞股蓝	饮食
三鲜翡翠汤	饮食
三鲜脱骨鱼	饮食
三鲜腐脑	饮食
三鲜芦笋	饮食
三鲜苦瓜汤	饮食
三鲜茄子	饮食
三鲜菜花	饮食
三鲜菠菜面	饮食
三鲜蒸饺	饮食
三鲜蒸鲮鱼球	饮食
三鲜蘑菇	饮食
三鲜豆皮	饮食
三鲜豆腐	饮食
三鲜豆腐火锅	饮食
三鲜豆腐盒	饮食
三鲜豆花汤	饮食
三鲜豆芽	饮食
三鲜酿圆子	饮食
三鲜酿面筋	饮食
三鲜锅塌蛋	饮食
三鲜锅巴	饮食
三鲜锅粑	饮食
三鲜长寿包	饮食
三鲜青豆汤	饮食
三鲜面	饮食
三鲜面片	饮食
三鲜饮	饮食
三鲜鱼唇	饮食
三鲜鱼片	饮食
三鲜鱼翅汤	饮食
三鲜鱼肚	饮食
三鲜鲍鱼	饮食
三鲜鳝汤	饮食
三鲜鸡糕汤	饮食
三鲜鹌鹑蛋	饮食
三鲜龙凤球	饮食
三黄油鸡	饮食
三黄鸡汤	饮食
上下九路	饮食
上四宝粥	饮食
上尊	饮食
上岛咖啡	饮食
上料鱼圆	饮食
上汤双色墨鱼丸	饮食
上汤大白菜	饮食
上汤奶白菜	饮食
上汤娃娃菜	饮食
上汤娃娃菜烩群菇	饮食
上汤扒娃娃菜	饮食
上汤油麦菜	饮食
上汤海蚌	饮食
上汤溜刀鱼脯	饮食
上汤火腿竹笋	饮食
上汤炸面焗花蟹	饮食
上汤焗原螺	饮食
上汤焗鲍鱼	饮食
上汤焗龙虾尾	饮食
上汤熻薄壳	饮食
上汤白菜	饮食
上汤皮蛋西兰花	饮食
上汤竹荪煲	饮食
上汤笋丝	饮食
上汤芝士龙虾	饮食
上汤芥兰	饮食
上汤芦笋竹荪	饮食
上汤菌菇木耳菜	饮食
上汤虾丸	饮食
上汤西兰花	饮食
上汤豌豆苗	饮食
上汤馄饨	饮食
上汤鱼饺	饮食
上汤鲜菇菜饭	饮食
上汤鸡毛菜	饮食
上汤龙凤卷	饮食
上汤龙虾面	饮食
上海卤鸭	饮食
上海咖喱牛肉干	饮食
上海品正餐饮管理有限	饮食
上海四季大酒店	饮食
上海大闸蟹礼券	饮食
上海家常炒酱	饮食
上海小吃	饮食
上海小汤包	饮食
上海春卷	饮食
上海枫泾丁蹄	饮食
上海棠糕	饮食
上海油鸡	饮食
上海熏鱼	饮食
上海猪肉松	饮食
上海白斩鸡	饮食
上海素火腿	饮食
上海色拉	饮食
上海菜	饮食
上海葱烧饼	饮食
上海进京乳腐	饮食
上海酱猪肉	饮食
上海醉蟹	饮食
上海锅贴	饮食
上海锐奇餐饮管理有限	饮食
上海青泡菜	饮食
上海风味清蒸葱油鸡	饮食
上海餐饮行业协会	饮食
上海餐饮行业协会章程	饮食
上海馄饨汤	饮食
上海香酥鸡	饮食
上素仙鹤	饮食
上素菜包	饮食
上饶白眉	饮食
上齐	饮食
什锦咖喱炒面	饮食
世果汇	饮食
世界三大烹饪王国	饮食
世界睾丸烹饪锦标赛	饮食
世界知名洋酒	饮食
世界食品科技大会	饮食
世界饮食文化	饮食
丝娃娃	饮食
丝瓜云耳滚肉片汤	饮食
丝瓜八角炒椰肉	饮食
丝瓜冷面线	饮食
丝瓜双虾水晶粉	饮食
丝瓜墨鱼汤	饮食
丝瓜嫩肉丸	饮食
丝瓜总汇	饮食
丝瓜木耳汤	饮食
丝瓜榨菜粉丝肉片汤	饮食
丝瓜毛豆炒鸡蛋	饮食
丝瓜汪豆腐	饮食
丝瓜沙茶牛肉	饮食
丝瓜油条汤	饮食
丝瓜海米蛋汤	饮食
丝瓜海米鸭蛋汤	饮食
丝瓜海蜇汤	饮食
丝瓜炒毛豆	饮食
丝瓜炒甜椒	饮食
丝瓜炒素	饮食
丝瓜炒紫甘蓝	饮食
丝瓜炒荔枝	饮食
丝瓜炒青豆	饮食
丝瓜炒面筋	饮食
丝瓜炒鸡球	饮食
丝瓜炒黑豆腐竹	饮食
丝瓜炖豆腐	饮食
丝瓜烘蛋汤	饮食
丝瓜烧毛豆米	饮食
丝瓜烩牡蛎	饮食
丝瓜烩蛤蜊	饮食
丝瓜烩面筋	饮食
丝瓜煮虾仁	饮食
丝瓜猪杂汤	饮食
丝瓜猪肝瘦肉汤	饮食
丝瓜瘦肉汤	饮食
丝瓜白果百舍煮银白花	饮食
丝瓜白菜猪瘦肉汤	饮食
丝瓜百合汤	饮食
丝瓜百合猪肝汤	饮食
丝瓜竹荪	饮食
丝瓜竹荪汤	饮食
丝瓜粉丝榨菜肉片汤	饮食
丝瓜络饮	饮食
丝瓜绿豆花汤	饮食
丝瓜肉丝粥	饮食
丝瓜肉片汤	饮食
丝瓜肉片蘑菇汤	饮食
丝瓜草菇滚鲮鱼球汤	饮食
丝瓜草菇肉丸汤	饮食
丝瓜荞麦面	饮食
丝瓜荷包蛋汤	饮食
丝瓜藤猪肉汤	饮食
丝瓜虾皮猪肝汤	饮食
丝瓜西红柿粥	饮食
丝瓜里脊汤	饮食
丝瓜银耳虾汤	饮食
丝瓜馓子汤	饮食
丝瓜鲢鱼汤	饮食
丝瓜鲢鱼滋补汤	饮食
丝瓜鲤鱼汤	饮食
丝袜奶茶	饮食
丝饼	饮食
TLC饮食	饮食
Tomasello蓝	饮食
《天天饮食》	饮食
豚肉海带香菇盅	饮食
《糖尿病行为医学技术	饮食
VELTLINER	饮食
Vieux-Boul	饮食
《吾三吾四的味觉人生	饮食
威斯丽红酒	饮食
《我的川菜生活》	饮食
万三肘子	饮食
万三蹄	饮食
万和春	饮食
万多福开心果	饮食
万子酥鸭	饮食
万字扣肉	饮食
万家飘香	饮食
万寿果生鱼汤	饮食
万寿羹	饮食
万寿菊糖水	饮食
万尼汁	饮食
万年青牌特珍	饮食
万香斋	饮食
万龙献宝	饮食
丸子牛肉萝卜汤	饮食
丸子羊肉汤	饮食
丸子胡萝卜汤	饮食
丸子香菇烩饭	饮食
X4威士忌	饮食
XO海鲜炒饭	饮食
XO肉酱拌面	饮食
XO酱拌冬瓜	饮食
xo酱挪威三文鱼炒饭	饮食
XO酱炒牛柳条	饮食
XO酱炒萝卜糕	饮食
XO酱烤小蚌	饮食
XO酱烧刺参	饮食
XO酱烧干贝虾仁蛋包	饮食
XO酱焗肠头	饮食
XO酱萝卜糕	饮食
XO酱鲜椒煎带子	饮食
XO鲜虾黄瓜	饮食
香菇萝卜骨头汤	饮食
下八珍	饮食
下午茶	饮食
下巴划水	饮食
下水汤	饮食
下水粉丝	饮食
下火大芥菜咸鱼头汤	饮食
《一学就会的意大利美	饮食
《元寶牛蒡》	饮食
《养小录》	饮食
《悦食悦已》	饮食
《扬州食话》	饮食
《育儿营养同步饮食全	饮食
幼儿园膳食计划	饮食
一个女人的神话	饮食
一串心	饮食
一主六配	饮食
一元套餐	饮食
一卵孵双凤	饮食
一口香肠	饮食
一口鲑鱼饺	饮食
一品包子	饮食
一品双味鸡	饮食
一品官燕	饮食
一品富贵鸡	饮食
一品寿桃	饮食
一品山药	饮食
一品料理	饮食
一品柿子	饮食
一品汽锅鸡	饮食
一品海参	饮食
一品海鲜	饮食
一品清汤燕窝	饮食
一品烤乳兔	饮食
一品烧鹿筋	饮食
一品熊掌	饮食
一品爽鱼肚	饮食
一品猴头菇	饮食
一品罗汉鸡	饮食
一品肉	饮食
一品蒸黄鱼	饮食
一品薯包	饮食
一品蟹粥	饮食
一品豆腐	饮食
一品豆腐汤	饮食
一品赤参	饮食
一品配方	饮食
一品酥方	饮食
一品酱方肉	饮食
一品酱羊肉	饮食
一品锅	饮食
一品飘香梅花糕	饮食
一品香大包	饮食
一品鲍鱼	饮食
一品鲜虾菜	饮食
一品鲜贝	饮食
一品鲳	饮食
一品鲳鱼	饮食
一心服务	饮食
一期一会自助烤肉	饮食
一根面	饮食
一桶香	饮食
一滴香	饮食
一碗居	饮食
一窝丝	饮食
一篓油	饮食
一线牵耳	饮食
一罐香	饮食
一锅香干锅鸭头火锅	饮食
一锅鲜	饮食
一锅鸳鸯鱼	饮食
一鱼两味	饮食
与食巨近	饮食
柚子鸡	饮食
严东关五加皮酒	饮食
严州白梨	饮食
有机鸡蛋	饮食
《中华美食》	饮食
《中国名食指南》	饮食
《中国月饼》	饮食
《中老年常见病饮食调	饮食
《准妈妈科学饮食》	饮食
《智慧岛》	饮食
《这样养育孩子最健康	饮食
丈母鱼丸汤	饮食
专业蛋挞	饮食
中乳酪蛋糕	饮食
中医食疗	饮食
中华井	饮食
中华味饭团	饮食
中华第一满汉全席	饮食
中华药膳	饮食
中华菜谱	饮食
中华贡鸡王	饮食
中华食品	饮食
中华食品网	饮食
中华食品论坛	饮食
中华食品魅力榜	饮食
中华饮食	饮食
中国387健康网	饮食
中国人九种体质之吃对	饮食
中国传统节日饮食习俗	饮食
中国八大名酒	饮食
中国八大菜系	饮食
中国冰淇淋	饮食
中国名菜典故	饮食
中国名蟹	饮食
中国国际有机食品和绿	饮食
中国料理	饮食
中国茶道	饮食
中国菜	饮食
中国菜系之乡	饮食
中国酒文化网	饮食
中国零食网	饮食
中国食品饮料网	饮食
中国餐饮产业信息网	饮食
中国饮食文化	饮食
中式三明治	饮食
中式如意蛋卷	饮食
中式小菜	饮食
中式沙拉	饮食
中式炸酱面	饮食
中式牛排	饮食
中式牛柳	饮食
中式牛肉汉堡	饮食
中式猪排饭	饮食
中式猪蹄瓜汤	饮食
中式百宝酿火鸡	饮食
中式红烧猪蹄	饮食
中式苹果派	饮食
中式茄酱意面	饮食
中式蹄扒海参	饮食
中式通心粉	饮食
中式香葱猪蹄	饮食
中江挂面	饮食
中法双松	饮食
中爪腐衣	饮食
中秋大团圆	饮食
中秋福利	饮食
中秋鱼	饮食
中秋鸡	饮食
中筋面粉	饮食
中绿华夏有机食品认证	饮食
中绿集团	饮食
中药八宝鲜鸡汤	饮食
中药茶	饮食
中药零食	饮食
中餐礼仪	饮食
保健花粥	饮食/烹饪/烹饪
保定驴肉火烧	饮食/烹饪/烹饪
CEPROC烹饪学校	饮食/烹饪/烹饪
CEPROC瑟铂克烹	饮食/烹饪/烹饪
《炒鸭肠》	饮食/烹饪/烹饪
丑鱼美味清蒸鸦片鱼头	饮食/烹饪/烹饪
串烧排骨	饮食/烹饪/烹饪
串烧海鲜	饮食/烹饪/烹饪
串烧韭菜鲜肉卷	饮食/烹饪/烹饪
串烧鸡柳	饮食/烹饪/烹饪
串烧黄鳝	饮食/烹饪/烹饪
串煎馄饨	饮食/烹饪/烹饪
串签麻辣烫	饮食/烹饪/烹饪
串肉意大利面	饮食/烹饪/烹饪
从小爱吃的菜	饮食/烹饪/烹饪
传统豆花	饮食/烹饪/烹饪
传统麦片曲奇	饮食/烹饪/烹饪
侧耳根叶拌胡豆	饮食/烹饪/烹饪
侧耳根拌鸡丝	饮食/烹饪/烹饪
DIY木瓜酸奶	饮食/烹饪/烹饪
丁丁辣子鸡	饮食/烹饪/烹饪
丁香小鱼	饮食/烹饪/烹饪
丁香排骨	饮食/烹饪/烹饪
丁香焖鸭	饮食/烹饪/烹饪
丁香肉丝	饮食/烹饪/烹饪
丁香肉桂鸭汤	饮食/烹饪/烹饪
丁香野兔肉	饮食/烹饪/烹饪
丁香野鸭	饮食/烹饪/烹饪
丁香雪梨汤	饮食/烹饪/烹饪
丁香鱼焗蝴蝶面	饮食/烹饪/烹饪
东乡手抓	饮食/烹饪/烹饪
东北凉拌菜	饮食/烹饪/烹饪
东北大锅烙	饮食/烹饪/烹饪
东北熏干豆腐肉卷	饮食/烹饪/烹饪
东北猪肉皮冻	饮食/烹饪/烹饪
东北玻璃叶饼	饮食/烹饪/烹饪
东北粘豆包	饮食/烹饪/烹饪
东北红烧肉	饮食/烹饪/烹饪
东北芥梗	饮食/烹饪/烹饪
东北菜	饮食/烹饪/烹饪
东北蘸酱菜	饮食/烹饪/烹饪
东北饭包	饮食/烹饪/烹饪
东坡扣肉	饮食/烹饪/烹饪
东坡牛脯	饮食/烹饪/烹饪
东坡狗肉	饮食/烹饪/烹饪
东坡茄子	饮食/烹饪/烹饪
东坡茄子煲	饮食/烹饪/烹饪
东坡饼	饮食/烹饪/烹饪
东安子鸡	饮食/烹饪/烹饪
东安鸡	饮食/烹饪/烹饪
东方市师鸡	饮食/烹饪/烹饪
东来葱煎饼	饮食/烹饪/烹饪
东江三味鱼头王	饮食/烹饪/烹饪
东江牛肉丸	饮食/烹饪/烹饪
东江瓤豆腐	饮食/烹饪/烹饪
东江盐焗鸡	饮食/烹饪/烹饪
东江豆腐煲	饮食/烹饪/烹饪
东江酿豆腐	饮食/烹饪/烹饪
东江香酥鸭	饮食/烹饪/烹饪
东江鱼丸	饮食/烹饪/烹饪
东海夫人炖猪手	饮食/烹饪/烹饪
东瓜水晶葡萄	饮食/烹饪/烹饪
东阳索粉	饮食/烹饪/烹饪
丹参海蜇煲	饮食/烹饪/烹饪
丹麦火腿	饮食/烹饪/烹饪
丹麦牛角包	饮食/烹饪/烹饪
代县麻片	饮食/烹饪/烹饪
低热量奶香苏打饼干	饮食/烹饪/烹饪
低热量核桃曲奇	饮食/烹饪/烹饪
低筋面粉	饮食/烹饪/烹饪
倒炝锅	饮食/烹饪/烹饪
倒笃菜蒸黑鱼片	饮食/烹饪/烹饪
党参北芪乳鸽汤	饮食/烹饪/烹饪
党参圆肉炖裙边	饮食/烹饪/烹饪
党参寄生鸡汤	饮食/烹饪/烹饪
党参当归炖猪腰	饮食/烹饪/烹饪
党参枸杞茶	饮食/烹饪/烹饪
党参海马炖乌鸡	饮食/烹饪/烹饪
党参淮山兔肉汤	饮食/烹饪/烹饪
党参炖乳鸽	饮食/烹饪/烹饪
党参炖鸡	饮食/烹饪/烹饪
党参烧鱼肚	饮食/烹饪/烹饪
党参生姜老鸡汤	饮食/烹饪/烹饪
党参田七炖牛尾	饮食/烹饪/烹饪
党参田七煲牛尾	饮食/烹饪/烹饪
党参百合猪肺汤	饮食/烹饪/烹饪
党参红枣煲牛腩	饮食/烹饪/烹饪
党参红枣黄芪鸡汤	饮食/烹饪/烹饪
党参羊肚汤	饮食/烹饪/烹饪
党参茯苓鸡	饮食/烹饪/烹饪
党参莲子鲤鱼汤	饮食/烹饪/烹饪
党参葛根猪月展汤	饮食/烹饪/烹饪
党参蛤蚧汤	饮食/烹饪/烹饪
党参郁金瘦肉汤	饮食/烹饪/烹饪
党参雪莲花鸡汤	饮食/烹饪/烹饪
党参青鱼汤	饮食/烹饪/烹饪
党参鲤鱼莲子汤	饮食/烹饪/烹饪
党参鳙鱼汤	饮食/烹饪/烹饪
党参鸡项汤	饮食/烹饪/烹饪
党参麦冬兔肉汤	饮食/烹饪/烹饪
党参黄芪炖鸡汤	饮食/烹饪/烹饪
二仙羊肉汤	饮食/烹饪/烹饪
二冬嫩蛋	饮食/烹饪/烹饪
二冬汤	饮食/烹饪/烹饪
二参玉竹瘦肉汤	饮食/烹饪/烹饪
二块粑	饮食/烹饪/烹饪
二子延年茶	饮食/烹饪/烹饪
二红汤	饮食/烹饪/烹饪
二金玉枣瘦肉汤	饮食/烹饪/烹饪
俄式培根烤大虾	饮食/烹饪/烹饪
俄罗斯烩牛肉	饮食/烹饪/烹饪
俄罗斯菜	饮食/烹饪/烹饪
俄罗斯菜卷	饮食/烹饪/烹饪
俄罗斯饺子	饮食/烹饪/烹饪
俄罗斯黑眼睛吐司	饮食/烹饪/烹饪
儿菜炒花肉	饮食/烹饪/烹饪
丰化摇蚶	饮食/烹饪/烹饪
丰化芋艿头	饮食/烹饪/烹饪
丰收玉米	饮食/烹饪/烹饪
丰收鱼虹	饮食/烹饪/烹饪
仿膳饽饽	饮食/烹饪/烹饪
佛山九层糕	饮食/烹饪/烹饪
佛手包	饮食/烹饪/烹饪
佛手南瓜鸡	饮食/烹饪/烹饪
佛手杂菌煲	饮食/烹饪/烹饪
佛手海蜇丝	饮食/烹饪/烹饪
佛手海蜇皮	饮食/烹饪/烹饪
佛手烩面筋	饮食/烹饪/烹饪
佛手瓜烧鸡翅	饮食/烹饪/烹饪
佛手菊花饮	饮食/烹饪/烹饪
佛手青椒	饮食/烹饪/烹饪
佛桃酥果	饮食/烹饪/烹饪
佛磬瓜盅	饮食/烹饪/烹饪
光棍鸡	饮食/烹饪/烹饪
光饼	饮食/烹饪/烹饪
光鸭肉冬瓜汤	饮食/烹饪/烹饪
何首乌煮鸡蛋	饮食/烹饪/烹饪
何首乌猪肝片	饮食/烹饪/烹饪
何首乌鲜鸡汤	饮食/烹饪/烹饪
何首乌鸡蛋汤	饮食/烹饪/烹饪
《家常凉菜》	饮食/烹饪/烹饪
《椒盐八宝鸡》	饮食/烹饪/烹饪
九世汤	饮食/烹饪/烹饪
九世汤香驴肉	饮食/烹饪/烹饪
九九如意菜	饮食/烹饪/烹饪
九孔藕煨猪弯弯	饮食/烹饪/烹饪
九层塔瘦肉汤	饮食/烹饪/烹饪
九曲桥	饮食/烹饪/烹饪
九月香辣蟹	饮食/烹饪/烹饪
九肚鱼烧豆腐	饮食/烹饪/烹饪
九节板	饮食/烹饪/烹饪
九节饼	饮食/烹饪/烹饪
九转大肠	饮食/烹饪/烹饪
九转豆腐	饮食/烹饪/烹饪
京华葱油饼	饮食/烹饪/烹饪
京味春饼鸡卷	饮食/烹饪/烹饪
京味烧羊腿	饮食/烹饪/烹饪
京味葱爆羊肉	饮食/烹饪/烹饪
京味酱爆肉	饮食/烹饪/烹饪
京味酱瓜虾	饮食/烹饪/烹饪
京味鸡肉手卷	饮食/烹饪/烹饪
京城烤鸭	饮食/烹饪/烹饪
京式绿豆桂花糕	饮食/烹饪/烹饪
京式酸辣汤	饮食/烹饪/烹饪
京果	饮食/烹饪/烹饪
京派炸酱冷面	饮食/烹饪/烹饪
京爆羊肝	饮食/烹饪/烹饪
京糕	饮食/烹饪/烹饪
京糕拌梨丝	饮食/烹饪/烹饪
京糕萝卜丝	饮食/烹饪/烹饪
京糕蜜汁雪梨丝	饮食/烹饪/烹饪
京糕雪梨	饮食/烹饪/烹饪
京葱培根卷	饮食/烹饪/烹饪
京葱炆牛方	饮食/烹饪/烹饪
京葱炒烤鸭丝	饮食/烹饪/烹饪
京葱牛腩	饮食/烹饪/烹饪
京葱羊糕	饮食/烹饪/烹饪
京葱铁板牛柳	饮食/烹饪/烹饪
京葱香煎鱼嘴	饮食/烹饪/烹饪
京都四味烧排骨	饮食/烹饪/烹饪
京都炝虾	饮食/烹饪/烹饪
京都骨	饮食/烹饪/烹饪
京酱大葱爆羊肉	饮食/烹饪/烹饪
京酱排骨	饮食/烹饪/烹饪
京酱牛肉丝便当	饮食/烹饪/烹饪
京酱肉丝春饼	饮食/烹饪/烹饪
京酱茄条	饮食/烹饪/烹饪
京酱西葫芦	饮食/烹饪/烹饪
京酱鸭肉	饮食/烹饪/烹饪
京酱龙虾球	饮食/烹饪/烹饪
借香	饮食/烹饪/烹饪
假海虾	饮食/烹饪/烹饪
假祭食	饮食/烹饪/烹饪
健力番茄饮	饮食/烹饪/烹饪
健康九层糕	饮食/烹饪/烹饪
健康果蔬汁	饮食/烹饪/烹饪
健胃甜瓜汁	饮食/烹饪/烹饪
健脑果汁	饮食/烹饪/烹饪
健脑核桃排骨汤	饮食/烹饪/烹饪
健脾益气糕	饮食/烹饪/烹饪
健脾益气鲫鱼羹	饮食/烹饪/烹饪
健脾祛暑三豆汤	饮食/烹饪/烹饪
健脾美肤兔肉	饮食/烹饪/烹饪
健脾补血腰片	饮食/烹饪/烹饪
健身西瓜盅	饮食/烹饪/烹饪
侉炖目鱼	饮食/烹饪/烹饪
侉炖豆腐鱼	饮食/烹饪/烹饪
两吃于贝	饮食/烹饪/烹饪
两吃活虾	饮食/烹饪/烹饪
两吃鳜鱼	饮食/烹饪/烹饪
两味绿豆汤	饮食/烹饪/烹饪
两彩大虾	饮食/烹饪/烹饪
两炸豆腐	饮食/烹饪/烹饪
丽江粑粑	饮食/烹饪/烹饪
丽江藕夹	饮食/烹饪/烹饪
丽江野鸭	饮食/烹饪/烹饪
乐仁堂药店	饮食/烹饪/烹饪
乐山辣子鸡	饮食/烹饪/烹饪
乱炖鳜鱼	饮食/烹饪/烹饪
伦教糕	饮食/烹饪/烹饪
《么么喳喳珍珠糖水》	饮食/烹饪/烹饪
乒乓馃	饮食/烹饪/烹饪
佩兰藿香茶	饮食/烹饪/烹饪
QQ的甜甜圈	饮食/烹饪/烹饪
QQ西瓜西米露	饮食/烹饪/烹饪
QQ香肠酥	饮食/烹饪/烹饪
七喜冰凉瓜	饮食/烹饪/烹饪
七宝祛斑饮	饮食/烹饪/烹饪
七彩什锦砂锅	饮食/烹饪/烹饪
七彩双菇	饮食/烹饪/烹饪
七彩墨鱼条	饮食/烹饪/烹饪
七彩日本冷面	饮食/烹饪/烹饪
七彩杂蔬西兰花	饮食/烹饪/烹饪
七彩杂锦煲	饮食/烹饪/烹饪
七彩汤	饮食/烹饪/烹饪
七彩烩胗芹	饮食/烹饪/烹饪
七彩神仙锅	饮食/烹饪/烹饪
七彩粉丝赠粉丝	饮食/烹饪/烹饪
七彩缤纷炒肉丁	饮食/烹饪/烹饪
七彩鲑鱼	饮食/烹饪/烹饪
七星丸	饮食/烹饪/烹饪
七星拼盘	饮食/烹饪/烹饪
七星鱼丸汤	饮食/烹饪/烹饪
乾县锅盔	饮食/烹饪/烹饪
乾州四宝	饮食/烹饪/烹饪
乾烧斑节虾	饮食/烹饪/烹饪
乾烧玉腐包	饮食/烹饪/烹饪
乾隆一品扣肉	饮食/烹饪/烹饪
乾隆驼汤	饮食/烹饪/烹饪
全丝烩鱼翅	饮食/烹饪/烹饪
全家富	饮食/烹饪/烹饪
全家福砂锅煲	饮食/烹饪/烹饪
全州拌饭	饮食/烹饪/烹饪
全羊大菜	饮食/烹饪/烹饪
全虾三做	饮食/烹饪/烹饪
全蛋海绵小花糕	饮食/烹饪/烹饪
全蛋玉米面蛋糕	饮食/烹饪/烹饪
全鱼席	饮食/烹饪/烹饪
全鸭冬瓜海参汤	饮食/烹饪/烹饪
全鸭海参冬瓜汤	饮食/烹饪/烹饪
全麦南瓜牛舌馒头	饮食/烹饪/烹饪
全麦吐司素酪小披萨	饮食/烹饪/烹饪
全麦核桃肉桂面包卷	饮食/烹饪/烹饪
全麦榛果葡萄干面包	饮食/烹饪/烹饪
全麦燕麦面包	饮食/烹饪/烹饪
全麦番茄饼三文治	饮食/烹饪/烹饪
全麦肉松面包	饮食/烹饪/烹饪
全麦腊牛肉洋葱盒	饮食/烹饪/烹饪
全麦芝麻蛋糕	饮食/烹饪/烹饪
全麦花生餐包	饮食/烹饪/烹饪
全麦葡萄干司康	饮食/烹饪/烹饪
乳椒空心菜	饮食/烹饪/烹饪
乳瓜炒芸豆	饮食/烹饪/烹饪
乳腐土豆	饮食/烹饪/烹饪
乳腐肉	饮食/烹饪/烹饪
乳腐鸭块	饮食/烹饪/烹饪
乳酪小纸杯蛋糕	饮食/烹饪/烹饪
乳酪布丁沙拉	饮食/烹饪/烹饪
乳酪梨子	饮食/烹饪/烹饪
乳酪烤桃	饮食/烹饪/烹饪
乳酪玉米糕	饮食/烹饪/烹饪
乳酪葡萄干土司	饮食/烹饪/烹饪
乳酪蒜香烤脆肠	饮食/烹饪/烹饪
乳酪面	饮食/烹饪/烹饪
乳香排骨	饮食/烹饪/烹饪
乳香黑鱼汤	饮食/烹饪/烹饪
乳鸽瓤猪肚	饮食/烹饪/烹饪
乳鸽瘦肉银耳汤	饮食/烹饪/烹饪
乳鸽红枣饭	饮食/烹饪/烹饪
乳鸽胡辣汤	饮食/烹饪/烹饪
乳鸽莲藕汤	饮食/烹饪/烹饪
乳鸽青菜汤	饮食/烹饪/烹饪
人参乌骨鸡	饮食/烹饪/烹饪
人参全鸡煲	饮食/烹饪/烹饪
人参哈士蟆	饮食/烹饪/烹饪
人参圆肉枣仁汤	饮食/烹饪/烹饪
人参天冬鲜鸡汤	饮食/烹饪/烹饪
人参小米粥	饮食/烹饪/烹饪
人参当归猪心汤	饮食/烹饪/烹饪
人参杞子瘦肉汤	饮食/烹饪/烹饪
人参枣仁圆肉汤	饮食/烹饪/烹饪
人参枸杞雪蛤汤	饮食/烹饪/烹饪
人参水泡菜	饮食/烹饪/烹饪
人参炖三鞭	饮食/烹饪/烹饪
人参炖乌鸡	饮食/烹饪/烹饪
人参炖鸡	饮食/烹饪/烹饪
人参猪肚	饮食/烹饪/烹饪
人参猪肚汤	饮食/烹饪/烹饪
人参猪蹄冻	饮食/烹饪/烹饪
人参珠鸡	饮食/烹饪/烹饪
人参田七羊肉汤	饮食/烹饪/烹饪
人参田七鸡汤	饮食/烹饪/烹饪
人参白糖炖猪瘦肉汤	饮食/烹饪/烹饪
人参竹筒洋松茸汤	饮食/烹饪/烹饪
人参红枣炒虾条	饮食/烹饪/烹饪
人参羊肉	饮食/烹饪/烹饪
人参群鲜汤	饮食/烹饪/烹饪
人参胎盘瘦肉汤	饮食/烹饪/烹饪
人参胡桃饮	饮食/烹饪/烹饪
人参胡桃鸡	饮食/烹饪/烹饪
人参花炖猴头蘑	饮食/烹饪/烹饪
人参茯苓汤	饮食/烹饪/烹饪
人参莲肉汤	饮食/烹饪/烹饪
人参薯蓣糕	饮食/烹饪/烹饪
人参蛤蚧汤	饮食/烹饪/烹饪
人参贝母鸡	饮食/烹饪/烹饪
人参银耳鸽蛋汤	饮食/烹饪/烹饪
人参鳜鱼	饮食/烹饪/烹饪
人参鸡肉鱼肚汤	饮食/烹饪/烹饪
人参鸡菇汤	饮食/烹饪/烹饪
人参麻雀粥	饮食/烹饪/烹饪
人参黄芪粥	饮食/烹饪/烹饪
人日生财汤	饮食/烹饪/烹饪
人民饭店	饮食/烹饪/烹饪
人气美食	饮食/烹饪/烹饪
《三絲敲魚》	饮食/烹饪/烹饪
《桑葚粥》	饮食/烹饪/烹饪
《神州问茶：中国茶痴	饮食/烹饪/烹饪
三丁炒松子	饮食/烹饪/烹饪
三丁炒玉米	饮食/烹饪/烹饪
三丁炒饭	饮食/烹饪/烹饪
三丁玉米	饮食/烹饪/烹饪
三丁茭白	饮食/烹饪/烹饪
三七蒸鸡	饮食/烹饪/烹饪
三七藕蛋汤	饮食/烹饪/烹饪
三不粘	饮食/烹饪/烹饪
三丝丸子	饮食/烹饪/烹饪
三丝发菜羹	饮食/烹饪/烹饪
三丝干巴菌	饮食/烹饪/烹饪
三丝年糕	饮食/烹饪/烹饪
三丝扒茄合	饮食/烹饪/烹饪
三丝拌粉皮	饮食/烹饪/烹饪
三丝拌糟鸡	饮食/烹饪/烹饪
三丝桂鱼	饮食/烹饪/烹饪
三丝炒蛋	饮食/烹饪/烹饪
三丝炒鸽松	饮食/烹饪/烹饪
三丝素鱼翅	饮食/烹饪/烹饪
三丝肚裆	饮食/烹饪/烹饪
三丝豆苗汤	饮食/烹饪/烹饪
三丝银鱼羹	饮食/烹饪/烹饪
三丝鲜鱼	饮食/烹饪/烹饪
三丝黄花菜	饮食/烹饪/烹饪
三丝龙袍	饮食/烹饪/烹饪
三全凌汤圆	饮食/烹饪/烹饪
三叶草面包	饮食/烹饪/烹饪
三合油香椿面	饮食/烹饪/烹饪
三味汤	饮食/烹饪/烹饪
三味灯笼虾	饮食/烹饪/烹饪
三味炖大鹅	饮食/烹饪/烹饪
三味白菜	饮食/烹饪/烹饪
三味美颜汁	饮食/烹饪/烹饪
三味肠饼	饮食/烹饪/烹饪
三味豆腐	饮食/烹饪/烹饪
三味黄瓜	饮食/烹饪/烹饪
三奇肉	饮食/烹饪/烹饪
三套鸭	饮食/烹饪/烹饪
三子炖猪腰汤	饮食/烹饪/烹饪
三宝炖仔鸭	饮食/烹饪/烹饪
三层色酒杯冻	饮食/烹饪/烹饪
三彩脆皮豆腐	饮食/烹饪/烹饪
三彩菠菜	饮食/烹饪/烹饪
三才鲜鸡汤	饮食/烹饪/烹饪
三文一品汤包	饮食/烹饪/烹饪
三文鱼北极贝鲜虾寿司	饮食/烹饪/烹饪
三文鱼土司卷	饮食/烹饪/烹饪
三文鱼头木瓜酸汤	饮食/烹饪/烹饪
三文鱼头浓汤	饮食/烹饪/烹饪
三文鱼头豆腐汤	饮食/烹饪/烹饪
三文鱼沙拉	饮食/烹饪/烹饪
三文鱼沙拉卷	饮食/烹饪/烹饪
三文鱼炒三丁	饮食/烹饪/烹饪
三文鱼腰果豆腐羹	饮食/烹饪/烹饪
三文鱼芦笋蘑菇面	饮食/烹饪/烹饪
三文鱼蒸蛋羹	饮食/烹饪/烹饪
三文鱼蔬菜蛋糕	饮食/烹饪/烹饪
三文鱼蘑菇汤面	饮食/烹饪/烹饪
三文鱼酸奶莳萝酱	饮食/烹饪/烹饪
三文鱼醪糟蛋羹	饮食/烹饪/烹饪
三文鱼饼	饮食/烹饪/烹饪
三文鱼骨奶酪汤	饮食/烹饪/烹饪
三文鱼鲜蔬沙拉	饮食/烹饪/烹饪
三文鱼黄瓜卷	饮食/烹饪/烹饪
三明治手卷	饮食/烹饪/烹饪
三杯开屏鱼	饮食/烹饪/烹饪
三杯田鸡	饮食/烹饪/烹饪
三杯臭豆腐	饮食/烹饪/烹饪
三杯锅巴鸡	饮食/烹饪/烹饪
三杯鳝段	饮食/烹饪/烹饪
三杯鸭	饮食/烹饪/烹饪
三果美体汁	饮食/烹饪/烹饪
三果营养汁	饮食/烹饪/烹饪
三果蜜汁	饮食/烹饪/烹饪
三样汤	饮食/烹饪/烹饪
三椒小肥羊	饮食/烹饪/烹饪
三汁闷花菜	饮食/烹饪/烹饪
三汁鸡翅焖锅	饮食/烹饪/烹饪
三油浸鱼	饮食/烹饪/烹饪
三珍蟹黄羹	饮食/烹饪/烹饪
三瓜瑶柱羹	饮食/烹饪/烹饪
三美豆腐	饮食/烹饪/烹饪
三色凉面	饮食/烹饪/烹饪
三色凤尾虾	饮食/烹饪/烹饪
三色印字饼干	饮食/烹饪/烹饪
三色圈饼	饮食/烹饪/烹饪
三色土豆饼	饮食/烹饪/烹饪
三色小蛋卷	饮食/烹饪/烹饪
三色布丁	饮食/烹饪/烹饪
三色条瓜	饮食/烹饪/烹饪
三色果冻	饮食/烹饪/烹饪
三色水果冰	饮食/烹饪/烹饪
三色沙虫	饮食/烹饪/烹饪
三色爆肚片	饮食/烹饪/烹饪
三色猫耳朵	饮食/烹饪/烹饪
三色百叶	饮食/烹饪/烹饪
三色粉卷	饮食/烹饪/烹饪
三色素卷	饮食/烹饪/烹饪
三色肉丸	饮食/烹饪/烹饪
三色肉圆	饮食/烹饪/烹饪
三色芝麻汤圆	饮食/烹饪/烹饪
三色蒸水蛋	饮食/烹饪/烹饪
三色蒸糕	饮食/烹饪/烹饪
三色蛋排	饮食/烹饪/烹饪
三色豆芽	饮食/烹饪/烹饪
三色青菜包	饮食/烹饪/烹饪
三色青豆泥	饮食/烹饪/烹饪
三色鸡鱼丸	饮食/烹饪/烹饪
三花头艳	饮食/烹饪/烹饪
三花茶	饮食/烹饪/烹饪
三花鱼肚	饮食/烹饪/烹饪
三花龙眼茶	饮食/烹饪/烹饪
三菇炖鱼头	饮食/烹饪/烹饪
三菇牛骨髓	饮食/烹饪/烹饪
三菇猴头	饮食/烹饪/烹饪
三菌肉丸野菜汤	饮食/烹饪/烹饪
三蔬蛤蜊汤	饮食/烹饪/烹饪
三衣银耳汤补体液	饮食/烹饪/烹饪
三角豆沙包	饮食/烹饪/烹饪
三角豆腐饺	饮食/烹饪/烹饪
三鲜冬瓜	饮食/烹饪/烹饪
三鲜口蘑锅巴	饮食/烹饪/烹饪
三鲜打卤面	饮食/烹饪/烹饪
三鲜拌豆腐	饮食/烹饪/烹饪
三鲜沙锅	饮食/烹饪/烹饪
三鲜海陆空	饮食/烹饪/烹饪
三鲜火锅	饮食/烹饪/烹饪
三鲜炒芦笋	饮食/烹饪/烹饪
三鲜炒蕨菜	饮食/烹饪/烹饪
三鲜烧真胗	饮食/烹饪/烹饪
三鲜烩拉皮	饮食/烹饪/烹饪
三鲜烩鱿鱼	饮食/烹饪/烹饪
三鲜玉米团	饮食/烹饪/烹饪
三鲜玉米羹	饮食/烹饪/烹饪
三鲜竹筒箜鱼皮饺	饮食/烹饪/烹饪
三鲜素海参	饮食/烹饪/烹饪
三鲜脱骨鱼	饮食/烹饪/烹饪
三鲜苦瓜汤	饮食/烹饪/烹饪
三鲜茶树菇	饮食/烹饪/烹饪
三鲜蘑菇	饮食/烹饪/烹饪
三鲜豆腐	饮食/烹饪/烹饪
三鲜豆腐盒	饮食/烹饪/烹饪
三鲜豆花汤	饮食/烹饪/烹饪
三鲜酿面筋	饮食/烹饪/烹饪
三鲜长寿包	饮食/烹饪/烹饪
三鲜青豆汤	饮食/烹饪/烹饪
三鲜饮	饮食/烹饪/烹饪
三鲜鱼唇	饮食/烹饪/烹饪
三鲜鱼片	饮食/烹饪/烹饪
三鲜鱼肉汤	饮食/烹饪/烹饪
三鲜鲍鱼	饮食/烹饪/烹饪
三黄鸡汤	饮食/烹饪/烹饪
三黑猪肚汤	饮食/烹饪/烹饪
上料鱼圆	饮食/烹饪/烹饪
上汤海蚌	饮食/烹饪/烹饪
上汤火腿竹笋	饮食/烹饪/烹饪
上汤炒饭	饮食/烹饪/烹饪
上汤焗鲍鱼	饮食/烹饪/烹饪
上汤皮蛋西兰花	饮食/烹饪/烹饪
上汤芝士龙虾	饮食/烹饪/烹饪
上汤芦笋竹荪	饮食/烹饪/烹饪
上汤菌菇木耳菜	饮食/烹饪/烹饪
上汤虾丸	饮食/烹饪/烹饪
上汤西兰花	饮食/烹饪/烹饪
上汤馄饨	饮食/烹饪/烹饪
上汤鱼片	饮食/烹饪/烹饪
上汤鸡丝河粉	饮食/烹饪/烹饪
上海咖喱牛肉干	饮食/烹饪/烹饪
上海家常炒酱	饮食/烹饪/烹饪
上海小吃	饮食/烹饪/烹饪
上海小汤包	饮食/烹饪/烹饪
上海春卷	饮食/烹饪/烹饪
上海枫泾丁蹄	饮食/烹饪/烹饪
上海熏鱼	饮食/烹饪/烹饪
上海猪肉松	饮食/烹饪/烹饪
上海白斩鸡	饮食/烹饪/烹饪
上海红烧肉	饮食/烹饪/烹饪
上海色拉	饮食/烹饪/烹饪
上海葱烧饼	饮食/烹饪/烹饪
上海醉蟹	饮食/烹饪/烹饪
上海锅贴	饮食/烹饪/烹饪
上素菜包	饮食/烹饪/烹饪
世界三大烹饪王国	饮食/烹饪/烹饪
丝瓜云耳滚肉片汤	饮食/烹饪/烹饪
丝瓜剁椒炒蛋	饮食/烹饪/烹饪
丝瓜培根煎蛋	饮食/烹饪/烹饪
丝瓜嫩肉丸	饮食/烹饪/烹饪
丝瓜总汇	饮食/烹饪/烹饪
丝瓜木耳汤	饮食/烹饪/烹饪
丝瓜核桃仁	饮食/烹饪/烹饪
丝瓜榨菜粉丝肉片汤	饮食/烹饪/烹饪
丝瓜汪豆腐	饮食/烹饪/烹饪
丝瓜海米蛋汤	饮食/烹饪/烹饪
丝瓜海米鸭蛋汤	饮食/烹饪/烹饪
丝瓜海蜇汤	饮食/烹饪/烹饪
丝瓜火腿蛋花汤	饮食/烹饪/烹饪
丝瓜炒青豆	饮食/烹饪/烹饪
丝瓜炒黑豆腐竹	饮食/烹饪/烹饪
丝瓜烘蛋汤	饮食/烹饪/烹饪
丝瓜烧毛豆米	饮食/烹饪/烹饪
丝瓜烧香芋	饮食/烹饪/烹饪
丝瓜烩牡蛎	饮食/烹饪/烹饪
丝瓜烩面筋	饮食/烹饪/烹饪
丝瓜烩香菇	饮食/烹饪/烹饪
丝瓜煮虾仁	饮食/烹饪/烹饪
丝瓜猪杂汤	饮食/烹饪/烹饪
丝瓜白果百舍煮银白花	饮食/烹饪/烹饪
丝瓜竹荪	饮食/烹饪/烹饪
丝瓜竹荪汤	饮食/烹饪/烹饪
丝瓜络饮	饮食/烹饪/烹饪
丝瓜肉丸草菇汤	饮食/烹饪/烹饪
丝瓜肉片汤	饮食/烹饪/烹饪
丝瓜花雕鸡	饮食/烹饪/烹饪
丝瓜草菇肉片汤	饮食/烹饪/烹饪
丝瓜荷包蛋汤	饮食/烹饪/烹饪
丝瓜莲子汤	饮食/烹饪/烹饪
丝瓜蒜蓉蒸蚝仔	饮食/烹饪/烹饪
丝瓜藤猪肉汤	饮食/烹饪/烹饪
丝瓜蘑菇汤	饮食/烹饪/烹饪
丝瓜虾皮汤	饮食/烹饪/烹饪
丝瓜虾米煎饼	饮食/烹饪/烹饪
丝瓜螺肉汤	饮食/烹饪/烹饪
丝瓜豆腐文蛤汤	饮食/烹饪/烹饪
丝瓜豆腐滚山斑鱼汤	饮食/烹饪/烹饪
丝瓜里脊汤	饮食/烹饪/烹饪
丝瓜银耳虾汤	饮食/烹饪/烹饪
丝瓜面筋汤	饮食/烹饪/烹饪
丝瓜香菇烧面筋	饮食/烹饪/烹饪
丝瓜魔芋美白汤	饮食/烹饪/烹饪
丝瓜鱼片冬菇汤	饮食/烹饪/烹饪
丝瓜鲜蘑汤	饮食/烹饪/烹饪
丝瓜鲢鱼汤	饮食/烹饪/烹饪
丝瓜鲢鱼滋补汤	饮食/烹饪/烹饪
丝瓜鸡蛋煎饼	饮食/烹饪/烹饪
陕西新纪元烹饪学校	饮食/烹饪/烹饪
什果茄汁桂鱼	饮食/烹饪/烹饪
什果马蹄冻糕	饮食/烹饪/烹饪
什菌炒腐竹	饮食/烹饪/烹饪
什蔬素烩	饮食/烹饪/烹饪
什蔬黑胡椒牛里脊	饮食/烹饪/烹饪
什锦一品锅	饮食/烹饪/烹饪
什锦丰收鱼	饮食/烹饪/烹饪
什锦元宵馅	饮食/烹饪/烹饪
什锦冬瓜帽	饮食/烹饪/烹饪
什锦卤味	饮食/烹饪/烹饪
什锦味噌汤	饮食/烹饪/烹饪
什锦味噌锅	饮食/烹饪/烹饪
什锦咖喱烩饭	饮食/烹饪/烹饪
什锦哈辣披萨	饮食/烹饪/烹饪
什锦天妇罗	饮食/烹饪/烹饪
什锦宫爆豆腐	饮食/烹饪/烹饪
什锦果盅	饮食/烹饪/烹饪
什锦水果戚风蛋糕	饮食/烹饪/烹饪
什锦泡粥	饮食/烹饪/烹饪
什锦泡菜	饮食/烹饪/烹饪
什锦浇汁粽子	饮食/烹饪/烹饪
什锦海参	饮食/烹饪/烹饪
什锦海味	饮食/烹饪/烹饪
什锦海鲜煲	饮食/烹饪/烹饪
什锦海鲜豆腐煲	饮食/烹饪/烹饪
什锦火锅	饮食/烹饪/烹饪
什锦炒杂菜	饮食/烹饪/烹饪
什锦炒饭	饮食/烹饪/烹饪
什锦炖粉条	饮食/烹饪/烹饪
什锦炸菜	饮食/烹饪/烹饪
什锦烤麸	饮食/烹饪/烹饪
什锦烩豆腐	饮食/烹饪/烹饪
什锦烩鸡	饮食/烹饪/烹饪
什锦煎蛋	饮食/烹饪/烹饪
什锦煲仔饭	饮食/烹饪/烹饪
什锦猪肉卷	饮食/烹饪/烹饪
什锦田园土豆饼	饮食/烹饪/烹饪
什锦番茄千层派	饮食/烹饪/烹饪
什锦盖饭	饮食/烹饪/烹饪
什锦素珍羹	饮食/烹饪/烹饪
什锦肉卷	饮食/烹饪/烹饪
什锦腐竹	饮食/烹饪/烹饪
什锦芦荟炒饭	饮食/烹饪/烹饪
什锦花枝	饮食/烹饪/烹饪
什锦莓果派	饮食/烹饪/烹饪
什锦菌菇	饮食/烹饪/烹饪
什锦菌菇鸡汤	饮食/烹饪/烹饪
什锦菜卷	饮食/烹饪/烹饪
什锦菠萝饭	饮食/烹饪/烹饪
什锦蒸饺	饮食/烹饪/烹饪
什锦蔬菜沙拉	饮食/烹饪/烹饪
什锦蛋包饭	饮食/烹饪/烹饪
什锦蛋饼丝	饮食/烹饪/烹饪
什锦蜂窝豆腐	饮食/烹饪/烹饪
什锦豆腐	饮食/烹饪/烹饪
什锦豆腐煲	饮食/烹饪/烹饪
什锦豇豆	饮食/烹饪/烹饪
什锦银针粉	饮食/烹饪/烹饪
什锦青椒羹	饮食/烹饪/烹饪
什锦面片汤	饮食/烹饪/烹饪
什锦饺子	饮食/烹饪/烹饪
什锦香肠冷切盘	饮食/烹饪/烹饪
什锦香菌汤	饮食/烹饪/烹饪
什香菜	饮食/烹饪/烹饪
什香鱼条	饮食/烹饪/烹饪
使君子瘦肉汤	饮食/烹饪/烹饪
兔丝拌面	饮食/烹饪/烹饪
兔头	饮食/烹饪/烹饪
兔肉汤	饮食/烹饪/烹饪
兔肉炒饼	饮食/烹饪/烹饪
兔肉炖粉条	饮食/烹饪/烹饪
兔肉粥	饮食/烹饪/烹饪
兔肉补虚汤	饮食/烹饪/烹饪
兔肉银耳汤	饮食/烹饪/烹饪
兔肝粥	饮食/烹饪/烹饪
《我的川菜生活》	饮食/烹饪/烹饪
万字扣肉	饮食/烹饪/烹饪
万寿菊糖水	饮食/烹饪/烹饪
万紫千红什锦	饮食/烹饪/烹饪
万龙洲海鲜餐饮集团	饮食/烹饪/烹饪
丸子丝瓜汤	饮食/烹饪/烹饪
丸子牛肉汤	饮食/烹饪/烹饪
丸子牛肉萝卜汤	饮食/烹饪/烹饪
丸子猪肉汤	饮食/烹饪/烹饪
丸子猪血炒腊肉	饮食/烹饪/烹饪
丸子猪血蒸腊肉	饮食/烹饪/烹饪
丸子白菜汤	饮食/烹饪/烹饪
丸子胡萝卜汤	饮食/烹饪/烹饪
丸子虾仁汤面	饮食/烹饪/烹饪
乌冬面	饮食/烹饪/烹饪
乌发汤	饮食/烹饪/烹饪
乌发糖	饮食/烹饪/烹饪
乌梅桂花汁	饮食/烹饪/烹饪
乌梅水果串烤肉	饮食/烹饪/烹饪
乌梅酒红茶饮	饮食/烹饪/烹饪
乌狼鲞烤肉	饮食/烹饪/烹饪
乌豆红枣圆肉汤	饮食/烹饪/烹饪
乌豆红枣塘虱鱼汤	饮食/烹饪/烹饪
乌豆老姜焖猪脚	饮食/烹饪/烹饪
乌豆茴归鸭蛋汤	饮食/烹饪/烹饪
乌豆莲子羊肉汤	饮食/烹饪/烹饪
乌豆龙眼炖山雀	饮食/烹饪/烹饪
乌骨鸡归黄汤	饮食/烹饪/烹饪
乌骨鸡黑米饭手卷	饮食/烹饪/烹饪
乌鱼丝瓜汤	饮食/烹饪/烹饪
乌鱼丸鲜蘑菇汤	饮食/烹饪/烹饪
乌鱼炖冬瓜	饮食/烹饪/烹饪
乌鱼花生排骨汤	饮食/烹饪/烹饪
乌鱼虾酱炖白菜	饮食/烹饪/烹饪
乌鸡凤菇汤	饮食/烹饪/烹饪
乌鸡大枣汤	饮食/烹饪/烹饪
乌鸡煲	饮食/烹饪/烹饪
乌鸡猴头菇汤	饮食/烹饪/烹饪
乌鸡白凤汤	饮食/烹饪/烹饪
乌鸡糯米葱白粥	饮食/烹饪/烹饪
乌鸡红枣煲	饮食/烹饪/烹饪
乌鸡肝粥	饮食/烹饪/烹饪
乌鸡花胶炖鱼翅	饮食/烹饪/烹饪
乌鸡萝卜煲	饮食/烹饪/烹饪
乌鸡雪蛤汤	饮食/烹饪/烹饪
乌龙叉汤	饮食/烹饪/烹饪
乌龙戏珠	饮食/烹饪/烹饪
乌龙报喜	饮食/烹饪/烹饪
乌龙舞三丝	饮食/烹饪/烹饪
乌龟茄子	饮食/烹饪/烹饪
五丁鱼圆	饮食/烹饪/烹饪
五丝蒸草鱼	饮食/烹饪/烹饪
五仁甜包	饮食/烹饪/烹饪
五仁红豆馅	饮食/烹饪/烹饪
五元神仙鸡	饮食/烹饪/烹饪
五元龟梨盅	饮食/烹饪/烹饪
五味双鲜	饮食/烹饪/烹饪
五味子川芎牛肉汤	饮食/烹饪/烹饪
五味子炖麻雀	饮食/烹饪/烹饪
五味巴戟粥	饮食/烹饪/烹饪
五味干丝	饮食/烹饪/烹饪
五味枸杞茶	饮食/烹饪/烹饪
五味汁炒茄子	饮食/烹饪/烹饪
五味炖鸡	饮食/烹饪/烹饪
五味煎蟹	饮食/烹饪/烹饪
五味花枝	饮食/烹饪/烹饪
五味萝卜浸鱿鱼	饮食/烹饪/烹饪
五味蒸肥牛	饮食/烹饪/烹饪
五味鸡腿	饮食/烹饪/烹饪
五子三文鱼串	饮食/烹饪/烹饪
五子粥	饮食/烹饪/烹饪
五子蒸鸡	饮食/烹饪/烹饪
五彩元宵	饮食/烹饪/烹饪
五彩奶香南瓜蛋糕	饮食/烹饪/烹饪
五彩宫灯豆腐	饮食/烹饪/烹饪
五彩桃仁香椿苗	饮食/烹饪/烹饪
五彩椒香小黄鱼	饮食/烹饪/烹饪
五彩水晶虾	饮食/烹饪/烹饪
五彩波丝花蓝	饮食/烹饪/烹饪
五彩炒米粉	饮食/烹饪/烹饪
五彩炒鲍鱼	饮食/烹饪/烹饪
五彩烤虾串	饮食/烹饪/烹饪
五彩爆鳝片	饮食/烹饪/烹饪
五彩猪肠粉	饮食/烹饪/烹饪
五彩班斓之茄汁鱼柳	饮食/烹饪/烹饪
五彩生菜炒虾仁	饮食/烹饪/烹饪
五彩疙瘩丝	饮食/烹饪/烹饪
五彩皮冻	饮食/烹饪/烹饪
五彩素丝	饮食/烹饪/烹饪
五彩紫菜汤	饮食/烹饪/烹饪
五彩绣球	饮食/烹饪/烹饪
五彩茶树菇	饮食/烹饪/烹饪
五彩菠菜	饮食/烹饪/烹饪
五彩虾仁	饮食/烹饪/烹饪
五彩虾仁卷	饮食/烹饪/烹饪
五彩虾松	饮食/烹饪/烹饪
五彩蟹盒	饮食/烹饪/烹饪
五彩西兰花	饮食/烹饪/烹饪
五彩豆丁	饮食/烹饪/烹饪
五彩豆皮	饮食/烹饪/烹饪
五彩豆腐丸	饮食/烹饪/烹饪
五彩里脊丝	饮食/烹饪/烹饪
五彩鱼丝	饮食/烹饪/烹饪
五彩鱼丸	饮食/烹饪/烹饪
五彩鱼米	饮食/烹饪/烹饪
五彩鱼粥	饮食/烹饪/烹饪
五彩鲜汤	饮食/烹饪/烹饪
五彩鲜贝	饮食/烹饪/烹饪
五彩鸡丁	饮食/烹饪/烹饪
五彩鸡丝	饮食/烹饪/烹饪
五彩鸡卷	饮食/烹饪/烹饪
五彩鸡肉粒	饮食/烹饪/烹饪
五彩鸭丝	饮食/烹饪/烹饪
五彩鸳鸯丝	饮食/烹饪/烹饪
五彩鸳鸯蛋	饮食/烹饪/烹饪
五彩鸽丝	饮食/烹饪/烹饪
五彩黑椒牛肉	饮食/烹饪/烹饪
五心花卷饭	饮食/烹饪/烹饪
五指茅桃煲老鸡	饮食/烹饪/烹饪
五末羹	饮食/烹饪/烹饪
五果炖元鱼	饮食/烹饪/烹饪
五柳料	饮食/烹饪/烹饪
五柳桂鱼	饮食/烹饪/烹饪
五柳青鱼	饮食/烹饪/烹饪
五柳鱼	饮食/烹饪/烹饪
五柳黄花鱼	饮食/烹饪/烹饪
五桃萸肉猪耳汤	饮食/烹饪/烹饪
五榖水果汁	饮食/烹饪/烹饪
五汁密膏	饮食/烹饪/烹饪
五汁饮	饮食/烹饪/烹饪
五环果仁炒鸡肉	饮食/烹饪/烹饪
五珍素包	饮食/烹饪/烹饪
五目炊饭	饮食/烹饪/烹饪
五神汤	饮食/烹饪/烹饪
五福汤	饮食/烹饪/烹饪
五福肘子	饮食/烹饪/烹饪
五色养生豆浆	饮食/烹饪/烹饪
五色旺菜卷	饮食/烹饪/烹饪
五色鱼米仁	饮食/烹饪/烹饪
五色鸡腰	饮食/烹饪/烹饪
五芝麻香鱼肉松	饮食/烹饪/烹饪
五花东坡肉	饮食/烹饪/烹饪
五花肉木耳炒白菜	饮食/烹饪/烹饪
五花肉炒泡菜	饮食/烹饪/烹饪
五花肉炒茶树菇	饮食/烹饪/烹饪
五花肉炒辣白菜	饮食/烹饪/烹饪
五花肉炒野干菌	饮食/烹饪/烹饪
五花肉炖小鱿鱼	饮食/烹饪/烹饪
五花肉炖萝卜	饮食/烹饪/烹饪
五花肉烧板栗	饮食/烹饪/烹饪
五花肉烧芋头	饮食/烹饪/烹饪
五花肉煸苦瓜	饮食/烹饪/烹饪
五花肉蘑菇烧萝卜	饮食/烹饪/烹饪
五花肉酸菜汤	饮食/烹饪/烹饪
五花腊肉石锅饭	饮食/烹饪/烹饪
五花豆腐干	饮食/烹饪/烹饪
五菌煲	饮食/烹饪/烹饪
五行菜	饮食/烹饪/烹饪
五谷丰登迎奥运	饮食/烹饪/烹饪
五谷喜庆饭	饮食/烹饪/烹饪
五谷紫菜卷	饮食/烹饪/烹饪
五谷蛋包饭	饮食/烹饪/烹饪
五谷蟹	饮食/烹饪/烹饪
五谷豆糙米粥	饮食/烹饪/烹饪
五谷鸡	饮食/烹饪/烹饪
五通桥叶儿耙	饮食/烹饪/烹饪
五香兰花干	饮食/烹饪/烹饪
五香卤牛腱	饮食/烹饪/烹饪
五香卤肉	饮食/烹饪/烹饪
五香卤鸡	饮食/烹饪/烹饪
五香叉烧	饮食/烹饪/烹饪
五香咸鸡腿	饮食/烹饪/烹饪
五香海带丝	饮食/烹饪/烹饪
五香火肠	饮食/烹饪/烹饪
五香烤鱼	饮食/烹饪/烹饪
五香烤鸡配生姜小白菜	饮食/烹饪/烹饪
五香煮花生	饮食/烹饪/烹饪
五香熏兔腿	饮食/烹饪/烹饪
五香熏鱼	饮食/烹饪/烹饪
五香熏黄鱼	饮食/烹饪/烹饪
五香牛筋斗	饮食/烹饪/烹饪
五香牛肉	饮食/烹饪/烹饪
五香牛肉丝	饮食/烹饪/烹饪
五香牛腱	饮食/烹饪/烹饪
五香狗肉汤	饮食/烹饪/烹饪
五香猪肉	饮食/烹饪/烹饪
五香皮冻	饮食/烹饪/烹饪
五香粉蒸排骨	饮食/烹饪/烹饪
五香素鸡翅	饮食/烹饪/烹饪
五香脱骨鸡	饮食/烹饪/烹饪
五香腌鸡蛋	饮食/烹饪/烹饪
五香腌鸭蛋	饮食/烹饪/烹饪
五香花色萝卜丝	饮食/烹饪/烹饪
五香芹菜	饮食/烹饪/烹饪
五香苦瓜	饮食/烹饪/烹饪
五香茶叶蛋	饮食/烹饪/烹饪
五香茶干炒蒜苔	饮食/烹饪/烹饪
五香茶抹羊肉	饮食/烹饪/烹饪
五香荷兰豆	饮食/烹饪/烹饪
五香萝卜丝	饮食/烹饪/烹饪
五香萝卜干	饮食/烹饪/烹饪
五香萝卜皮	饮食/烹饪/烹饪
五香豆筋	饮食/烹饪/烹饪
五香辣毛豆	饮食/烹饪/烹饪
五香辣猪手	饮食/烹饪/烹饪
五香辣萝卜皮	饮食/烹饪/烹饪
五香酱熏鱼	饮食/烹饪/烹饪
五香酱牛肉	饮食/烹饪/烹饪
五香酱肘子	饮食/烹饪/烹饪
五香酱鸭	饮食/烹饪/烹饪
五香鱼	饮食/烹饪/烹饪
五香鱼饼	饮食/烹饪/烹饪
五香鸡胗	饮食/烹饪/烹饪
五香鸭肉	饮食/烹饪/烹饪
五香鸽子	饮食/烹饪/烹饪
五香麦片粥	饮食/烹饪/烹饪
XO海鲜炒饭	饮食/烹饪/烹饪
XO肉酱拌面	饮食/烹饪/烹饪
XO酱拌冬瓜	饮食/烹饪/烹饪
XO酱拌凉皮	饮食/烹饪/烹饪
xo酱挪威三文鱼炒饭	饮食/烹饪/烹饪
XO酱海鲜炒面	饮食/烹饪/烹饪
XO酱炒萝卜糕	饮食/烹饪/烹饪
XO酱烧菜心	饮食/烹饪/烹饪
XO酱焗肠头	饮食/烹饪/烹饪
XO鲜虾黄瓜	饮食/烹饪/烹饪
《夏日田园》	饮食/烹饪/烹饪
《西方饮食文化》	饮食/烹饪/烹饪
下八珍	饮食/烹饪/烹饪
下巴划水	饮食/烹饪/烹饪
下水粉丝	饮食/烹饪/烹饪
下火大芥菜咸鱼头汤	饮食/烹饪/烹饪
乡土肉粽	饮食/烹饪/烹饪
乡村小土豆	饮食/烹饪/烹饪
乡村蛋黄卷	饮食/烹饪/烹饪
乡村鲫鱼	饮食/烹饪/烹饪
乡野风味羹	饮食/烹饪/烹饪
仙人掌南瓜盅	饮食/烹饪/烹饪
仙人掌炒牛肉	饮食/烹饪/烹饪
仙人掌炒虾仁	饮食/烹饪/烹饪
仙人掌炒青红椒	饮食/烹饪/烹饪
仙人掌烧鸡块	饮食/烹饪/烹饪
仙人粥	饮食/烹饪/烹饪
仙枣赤豆粥	饮食/烹饪/烹饪
仙灵酒	饮食/烹饪/烹饪
仙茅煲大虾	饮食/烹饪/烹饪
仙茅雀肉汤	饮食/烹饪/烹饪
仙鹤草鹌鹑萝卜汤	饮食/烹饪/烹饪
仙鹤薏米粥	饮食/烹饪/烹饪
像生南瓜	饮食/烹饪/烹饪
一卵孵双凤	饮食/烹饪/烹饪
一品官燕	饮食/烹饪/烹饪
一品寿桃	饮食/烹饪/烹饪
一品山药	饮食/烹饪/烹饪
一品海参	饮食/烹饪/烹饪
一品烧鹿筋	饮食/烹饪/烹饪
一品肉	饮食/烹饪/烹饪
一品芙蓉鳜	饮食/烹饪/烹饪
一品薯包	饮食/烹饪/烹饪
一品赤参	饮食/烹饪/烹饪
一品香辣虾	饮食/烹饪/烹饪
一品鲍鱼	饮食/烹饪/烹饪
一品鲜贝	饮食/烹饪/烹饪
一品鲳	饮食/烹饪/烹饪
一品黄雀	饮食/烹饪/烹饪
一生要素	饮食/烹饪/烹饪
一罐香	饮食/烹饪/烹饪
一觉回味鸭	饮食/烹饪/烹饪
一锅鲜	饮食/烹饪/烹饪
一锅鸳鸯鱼	饮食/烹饪/烹饪
一鱼两味	饮食/烹饪/烹饪
义式香脂醋酱拌田园沙	饮食/烹饪/烹饪
义腿肾鞭	饮食/烹饪/烹饪
云丝干贝豆腐汤	饮食/烹饪/烹饪
云南丽江粑粑	饮食/烹饪/烹饪
云南小瓜炒肥牛	饮食/烹饪/烹饪
云南春卷	饮食/烹饪/烹饪
云南泸西凉米线	饮食/烹饪/烹饪
云南红三剁	饮食/烹饪/烹饪
云吞	饮食/烹饪/烹饪
云呢拿忌廉布甸	饮食/烹饪/烹饪
云托八鲜	饮食/烹饪/烹饪
云河段霄	饮食/烹饪/烹饪
云片竹荪汤	饮食/烹饪/烹饪
云片糕	饮食/烹饪/烹饪
云片豆腐汤	饮食/烹饪/烹饪
云片豆腐脑	饮食/烹饪/烹饪
云片鸽蛋	饮食/烹饪/烹饪
云片鹿角菜	饮食/烹饪/烹饪
云猪手	饮食/烹饪/烹饪
云罗黄鱼	饮食/烹饪/烹饪
云耳丝瓜滚肉片汤	饮食/烹饪/烹饪
云耳冬菇炒鸡	饮食/烹饪/烹饪
云耳冬菇瘦肉粥	饮食/烹饪/烹饪
云耳沙榄炖猪展	饮食/烹饪/烹饪
云耳海参猪肠汤	饮食/烹饪/烹饪
云耳海米炒紫苔	饮食/烹饪/烹饪
云耳番茄汤	饮食/烹饪/烹饪
云耳蒸牛肝	饮食/烹饪/烹饪
云耳蜜瓜甘笋黄豆汤	饮食/烹饪/烹饪
云腿护国菜	饮食/烹饪/烹饪
云腿炒苦瓜	饮食/烹饪/烹饪
云腿鸽子汤	饮食/烹饪/烹饪
云苓党参扇骨炖龟汤	饮食/烹饪/烹饪
云苓冬瓜蛏子肉汤	饮食/烹饪/烹饪
云苓杭菊猪肝汤	饮食/烹饪/烹饪
云苓簕苋菜头鲫鱼汤	饮食/烹饪/烹饪
云豆煲猪手	饮食/烹饪/烹饪
云飓珧柱蔬菜羹	饮食/烹饪/烹饪
元参红枣汤	饮食/烹饪/烹饪
元宝大花蟹	饮食/烹饪/烹饪
元宝牛蒡	饮食/烹饪/烹饪
元宝花卷	饮食/烹饪/烹饪
元宝落满盘	饮食/烹饪/烹饪
元菇烧鸡	饮食/烹饪/烹饪
元蘑土豆片	饮食/烹饪/烹饪
元蛤巧达汤	饮食/烹饪/烹饪
元西鱼片豆腐汤	饮食/烹饪/烹饪
元贝米浆粥	饮食/烹饪/烹饪
猪血	饮食/烹饪/烹饪
《怎样炒菜更营养》	饮食/烹饪/烹饪
专业蛋挞	饮食/烹饪/烹饪
中东蚕豆香饭	饮食/烹饪/烹饪
中乳酪蛋糕	饮食/烹饪/烹饪
中国乡土菜研究协会四	饮食/烹饪/烹饪
中国烹饪协会名厨专业	饮食/烹饪/烹饪
中国菜	饮食/烹饪/烹饪
中国菜系之乡	饮食/烹饪/烹饪
中式三明治	饮食/烹饪/烹饪
中式如意蛋卷	饮食/烹饪/烹饪
中式沙拉	饮食/烹饪/烹饪
中式花生糕	饮食/烹饪/烹饪
中式茄酱意面	饮食/烹饪/烹饪
中式菜肴研发中心	饮食/烹饪/烹饪
中法双松	饮食/烹饪/烹饪
中爪腐衣	饮食/烹饪/烹饪
中秋大团圆	饮食/烹饪/烹饪
中秋鱼	饮食/烹饪/烹饪
中秋鸡	饮食/烹饪/烹饪
中筋面粉	饮食/烹饪/烹饪
中药八宝鲜鸡汤	饮食/烹饪/烹饪
中餐冷菜烹饪调味料	饮食/烹饪/烹饪
中国国际厨师协会	饮食/烹饪/烹饪
仔姜爆乳鸽	饮食/烹饪/烹饪
仔蒜蓉豆豉蚬肉意粉	饮食/烹饪/烹饪
仲景羊肉汤	饮食/烹饪/烹饪
炸肥肠	饮食/烹饪/烹饪
兆朗年糕汤	饮食/烹饪/烹饪
安徽菜	饮食/烹饪/中国烹饪/中国烹饪
安神首乌粥	饮食/烹饪/中国烹饪/中国烹饪
安福金品火腿厂	饮食/烹饪/中国烹饪/中国烹饪
安阳三熏	饮食/烹饪/中国烹饪/中国烹饪
八仙瑶池聚会	饮食/烹饪/中国烹饪/中国烹饪
八仙过海闹罗汉	饮食/烹饪/中国烹饪/中国烹饪
八味酿笋	饮食/烹饪/中国烹饪/中国烹饪
八块鸡	饮食/烹饪/中国烹饪/中国烹饪
八宝山药泥	饮食/烹饪/中国烹饪/中国烹饪
八宝糯米鸡	饮食/烹饪/中国烹饪/中国烹饪
八宝芡实粥	饮食/烹饪/中国烹饪/中国烹饪
八宝茶	饮食/烹饪/中国烹饪/中国烹饪
八宝葫芦鸡	饮食/烹饪/中国烹饪/中国烹饪
八宝蒸乌鸡	饮食/烹饪/中国烹饪/中国烹饪
八宝酿香瓜	饮食/烹饪/中国烹饪/中国烹饪
八宝青蟹饭	饮食/烹饪/中国烹饪/中国烹饪
八宝香糯	饮食/烹饪/中国烹饪/中国烹饪
八宝鸡	饮食/烹饪/中国烹饪/中国烹饪
八宝鸭羹	饮食/烹饪/中国烹饪/中国烹饪
八生火锅	饮食/烹饪/中国烹饪/中国烹饪
冰冻茄丁	饮食/烹饪/中国烹饪/中国烹饪
冰奶茶	饮食/烹饪/中国烹饪/中国烹饪
冰糖乳鸽燕窝羹	饮食/烹饪/中国烹饪/中国烹饪
冰糖密桃	饮食/烹饪/中国烹饪/中国烹饪
冰糖湘莲	饮食/烹饪/中国烹饪/中国烹饪
冰糖燕窝	饮食/烹饪/中国烹饪/中国烹饪
冰糖莲子	饮食/烹饪/中国烹饪/中国烹饪
冰糖麻雀	饮食/烹饪/中国烹饪/中国烹饪
冰糟肘子	饮食/烹饪/中国烹饪/中国烹饪
冰花士干圈	饮食/烹饪/中国烹饪/中国烹饪
冰镇番茄汁	饮食/烹饪/中国烹饪/中国烹饪
冰镇胡萝卜汁	饮食/烹饪/中国烹饪/中国烹饪
冰镇芦笋汁	饮食/烹饪/中国烹饪/中国烹饪
包面	饮食/烹饪/中国烹饪/中国烹饪
北京烤鸭	饮食/烹饪/中国烹饪/中国烹饪
北杏参地老鸭汤	饮食/烹饪/中国烹饪/中国烹饪
北芪瘦肉	饮食/烹饪/中国烹饪/中国烹饪
半支莲粥	饮食/烹饪/中国烹饪/中国烹饪
半炉鸡	饮食/烹饪/中国烹饪/中国烹饪
半煎煮金龙鱼	饮食/烹饪/中国烹饪/中国烹饪
半煎煮银鱼	饮食/烹饪/中国烹饪/中国烹饪
宝酿龙瓜	饮食/烹饪/中国烹饪/中国烹饪
巴国玉米糕	饮食/烹饪/中国烹饪/中国烹饪
巴国萝卜干狗肉汤	饮食/烹饪/中国烹饪/中国烹饪
悲翠裙边	饮食/烹饪/中国烹饪/中国烹饪
扁豆仁糕	饮食/烹饪/中国烹饪/中国烹饪
扁豆花煎鸭蛋	饮食/烹饪/中国烹饪/中国烹饪
扁豆薏米炖鸡脚	饮食/烹饪/中国烹饪/中国烹饪
扒三样	饮食/烹饪/中国烹饪/中国烹饪
扒原壳鲍鱼	饮食/烹饪/中国烹饪/中国烹饪
扒大肠油菜	饮食/烹饪/中国烹饪/中国烹饪
扒栗子	饮食/烹饪/中国烹饪/中国烹饪
扒牛肉条	饮食/烹饪/中国烹饪/中国烹饪
扒白菇	饮食/烹饪/中国烹饪/中国烹饪
扒糕	饮食/烹饪/中国烹饪/中国烹饪
扒素子双菇	饮食/烹饪/中国烹饪/中国烹饪
扒鲍鱼芦笋	饮食/烹饪/中国烹饪/中国烹饪
扒鸡腿	饮食/烹饪/中国烹饪/中国烹饪
扒龙须鲍鱼	饮食/烹饪/中国烹饪/中国烹饪
拌莴笋	饮食/烹饪/中国烹饪/中国烹饪
拌豆腐干丝	饮食/烹饪/中国烹饪/中国烹饪
拌鸡块	饮食/烹饪/中国烹饪/中国烹饪
拌鸭掌	饮食/烹饪/中国烹饪/中国烹饪
拔丝楂糕	饮食/烹饪/中国烹饪/中国烹饪
拔丝苹果	饮食/烹饪/中国烹饪/中国烹饪
拔丝蜜桔	饮食/烹饪/中国烹饪/中国烹饪
斑鱼汤	饮食/烹饪/中国烹饪/中国烹饪
板兰根粥	饮食/烹饪/中国烹饪/中国烹饪
板栗烧鳝段	饮食/烹饪/中国烹饪/中国烹饪
板栗焖仔鸡	饮食/烹饪/中国烹饪/中国烹饪
板栗煲老鸡	饮食/烹饪/中国烹饪/中国烹饪
板栗红烧肉	饮食/烹饪/中国烹饪/中国烹饪
柏皮扣	饮食/烹饪/中国烹饪/中国烹饪
棒棒鸡	饮食/烹饪/中国烹饪/中国烹饪
棒棒鸡丝	饮食/烹饪/中国烹饪/中国烹饪
槟榔排骨锅	饮食/烹饪/中国烹饪/中国烹饪
串串香	饮食/烹饪/中国烹饪/中国烹饪
串烤肉	饮食/烹饪/中国烹饪/中国烹饪
串烧海鲜	饮食/烹饪/中国烹饪/中国烹饪
串煎馄饨	饮食/烹饪/中国烹饪/中国烹饪
参巴辣椒酱	饮食/烹饪/中国烹饪/中国烹饪
参果炖瘦肉	饮食/烹饪/中国烹饪/中国烹饪
参芪母鸡汤	饮食/烹饪/中国烹饪/中国烹饪
参芪红枣乳鸽汤	饮食/烹饪/中国烹饪/中国烹饪
参芪胶艾粥	饮食/烹饪/中国烹饪/中国烹饪
参茸鸡肉汤	饮食/烹饪/中国烹饪/中国烹饪
参莲茶	饮食/烹饪/中国烹饪/中国烹饪
参蒸鳝段	饮食/烹饪/中国烹饪/中国烹饪
参附鸡	饮食/烹饪/中国烹饪/中国烹饪
参附鸽	饮食/烹饪/中国烹饪/中国烹饪
参麦团鱼	饮食/烹饪/中国烹饪/中国烹饪
参麦雪梨瘦肉汤	饮食/烹饪/中国烹饪/中国烹饪
叉烧	饮食/烹饪/中国烹饪/中国烹饪
叉烧炒面	饮食/烹饪/中国烹饪/中国烹饪
叉烧鱼	饮食/烹饪/中国烹饪/中国烹饪
叉烧鸡	饮食/烹饪/中国烹饪/中国烹饪
叉烧鸭	饮食/烹饪/中国烹饪/中国烹饪
川冬菜炒鲜蚕豆	饮食/烹饪/中国烹饪/中国烹饪
川味牛肉	饮食/烹饪/中国烹饪/中国烹饪
川味糯米饭	饮食/烹饪/中国烹饪/中国烹饪
川味蟹	饮食/烹饪/中国烹饪/中国烹饪
川断羊肾粥	饮食/烹饪/中国烹饪/中国烹饪
川糟暖锅	饮食/烹饪/中国烹饪/中国烹饪
川西肉豆腐	饮食/烹饪/中国烹饪/中国烹饪
川贝母海蜇瘦肉汤	饮食/烹饪/中国烹饪/中国烹饪
川贝炖梨	饮食/烹饪/中国烹饪/中国烹饪
川贝炖鹧鸪	饮食/烹饪/中国烹饪/中国烹饪
川贝芡实鹧鸪汤	饮食/烹饪/中国烹饪/中国烹饪
川贝雪梨猪肺汤	饮食/烹饪/中国烹饪/中国烹饪
川辣蟹	饮食/烹饪/中国烹饪/中国烹饪
川辣黄瓜	饮食/烹饪/中国烹饪/中国烹饪
川鱼头火锅	饮食/烹饪/中国烹饪/中国烹饪
彩丝金柳	饮食/烹饪/中国烹饪/中国烹饪
彩带鱼头	饮食/烹饪/中国烹饪/中国烹饪
彩椒炒香肠	饮食/烹饪/中国烹饪/中国烹饪
彩珠牛宝	饮食/烹饪/中国烹饪/中国烹饪
彩色肉丝	饮食/烹饪/中国烹饪/中国烹饪
彩虹鸡丁	饮食/烹饪/中国烹饪/中国烹饪
成都泡椒墨鱼仔	饮食/烹饪/中国烹饪/中国烹饪
成都蛋汤	饮食/烹饪/中国烹饪/中国烹饪
拆冻鲫鱼	饮食/烹饪/中国烹饪/中国烹饪
捶烩鸡片	饮食/烹饪/中国烹饪/中国烹饪
捶鸡	饮食/烹饪/中国烹饪/中国烹饪
春卷	饮食/烹饪/中国烹饪/中国烹饪
春笋炒步鱼	饮食/烹饪/中国烹饪/中国烹饪
春笋豌豆	饮食/烹饪/中国烹饪/中国烹饪
春饼	饮食/烹饪/中国烹饪/中国烹饪
朝日啤酒	饮食/烹饪/中国烹饪/中国烹饪
朝阳鸡蛋豆腐	饮食/烹饪/中国烹饪/中国烹饪
柴归陈皮蛋	饮食/烹饪/中国烹饪/中国烹饪
柴胡青叶粥	饮食/烹饪/中国烹饪/中国烹饪
椿芽焖蛋	饮食/烹饪/中国烹饪/中国烹饪
丁香鱼饺	饮食/烹饪/中国烹饪/中国烹饪
丁香鸭	饮食/烹饪/中国烹饪/中国烹饪
东坡春鸠脍	饮食/烹饪/中国烹饪/中国烹饪
东坡肉	饮食/烹饪/中国烹饪/中国烹饪
东坡肘子	饮食/烹饪/中国烹饪/中国烹饪
东坡蒸猪头	饮食/烹饪/中国烹饪/中国烹饪
东坡鳊鱼	饮食/烹饪/中国烹饪/中国烹饪
东壁龙珠	饮食/烹饪/中国烹饪/中国烹饪
东安子鸡	饮食/烹饪/中国烹饪/中国烹饪
东安鸡	饮食/烹饪/中国烹饪/中国烹饪
东江盐焗鸡	饮食/烹饪/中国烹饪/中国烹饪
东江豆腐煲	饮食/烹饪/中国烹饪/中国烹饪
东璧龙珠	饮食/烹饪/中国烹饪/中国烹饪
丹参黄豆汤	饮食/烹饪/中国烹饪/中国烹饪
侗乡腌鱼	饮食/烹饪/中国烹饪/中国烹饪
党参北芪牛肚汤	饮食/烹饪/中国烹饪/中国烹饪
党参延胡肉汤	饮食/烹饪/中国烹饪/中国烹饪
党参黄芪炖鸡汤	饮食/烹饪/中国烹饪/中国烹饪
冬冬菇托儿	饮食/烹饪/中国烹饪/中国烹饪
冬杏田鸡精	饮食/烹饪/中国烹饪/中国烹饪
冬瓜排骨清汤	饮食/烹饪/中国烹饪/中国烹饪
冬瓜汤谱	饮食/烹饪/中国烹饪/中国烹饪
冬瓜炖排骨	饮食/烹饪/中国烹饪/中国烹饪
冬瓜煲汤	饮食/烹饪/中国烹饪/中国烹饪
冬瓜竹笋鸡	饮食/烹饪/中国烹饪/中国烹饪
冬瓜赤小豆金银肾汤	饮食/烹饪/中国烹饪/中国烹饪
冬瓜连锅汤	饮食/烹饪/中国烹饪/中国烹饪
冬瓜鲜荷叶煲鸭	饮食/烹饪/中国烹饪/中国烹饪
冬瓜鳖裙羹	饮食/烹饪/中国烹饪/中国烹饪
冬瓜鳢鱼汤	饮食/烹饪/中国烹饪/中国烹饪
冬笋三黄鸡	饮食/烹饪/中国烹饪/中国烹饪
冬笋牛肉丝	饮食/烹饪/中国烹饪/中国烹饪
冬笋虾卷	饮食/烹饪/中国烹饪/中国烹饪
冬笋雪菜黄鱼汤	饮食/烹饪/中国烹饪/中国烹饪
冬笋鸽脯	饮食/烹饪/中国烹饪/中国烹饪
冬茸白兰	饮食/烹饪/中国烹饪/中国烹饪
冬菇扒茼蒿	饮食/烹饪/中国烹饪/中国烹饪
冬菇烧蹄筋	饮食/烹饪/中国烹饪/中国烹饪
冬菇雪耳猪胰汤	饮食/烹饪/中国烹饪/中国烹饪
冬菇马蹄苋菜豆腐羹	饮食/烹饪/中国烹饪/中国烹饪
冬菇鸡脚汤	饮食/烹饪/中国烹饪/中国烹饪
冬菜扣大鸭	饮食/烹饪/中国烹饪/中国烹饪
冬菜扣肉	饮食/烹饪/中国烹饪/中国烹饪
冬菜炖鸭	饮食/烹饪/中国烹饪/中国烹饪
冬菜焖鸭	饮食/烹饪/中国烹饪/中国烹饪
冬菜肉末	饮食/烹饪/中国烹饪/中国烹饪
冬虫夏草烩番茄	饮食/烹饪/中国烹饪/中国烹饪
冬虫夏草童子鸡汤	饮食/烹饪/中国烹饪/中国烹饪
冬虫夏草龟汤	饮食/烹饪/中国烹饪/中国烹饪
冬虫草炖水鱼	饮食/烹饪/中国烹饪/中国烹饪
冻豆腐金针	饮食/烹饪/中国烹饪/中国烹饪
刀削面	饮食/烹饪/中国烹饪/中国烹饪
剁椒胖鱼头	饮食/烹饪/中国烹饪/中国烹饪
剁椒蒸鳊鱼	饮食/烹饪/中国烹饪/中国烹饪
剁椒鱼头	饮食/烹饪/中国烹饪/中国烹饪
地栗糕	饮食/烹饪/中国烹饪/中国烹饪
地瓜糖	饮食/烹饪/中国烹饪/中国烹饪
地胆头炖猪月展	饮食/烹饪/中国烹饪/中国烹饪
多味鱼汤	饮食/烹饪/中国烹饪/中国烹饪
多味黄瓜	饮食/烹饪/中国烹饪/中国烹饪
大列巴	饮食/烹饪/中国烹饪/中国烹饪
大千子鸡	饮食/烹饪/中国烹饪/中国烹饪
大地鱼滚豆腐汤	饮食/烹饪/中国烹饪/中国烹饪
大地鱼猪瘦肉滚豆腐汤	饮食/烹饪/中国烹饪/中国烹饪
大枣冬菇汤	饮食/烹饪/中国烹饪/中国烹饪
大枣姜汤	饮食/烹饪/中国烹饪/中国烹饪
大枣甘草汤	饮食/烹饪/中国烹饪/中国烹饪
大枣百合汤	饮食/烹饪/中国烹饪/中国烹饪
大白菜水饺	饮食/烹饪/中国烹饪/中国烹饪
大盘肚	饮食/烹饪/中国烹饪/中国烹饪
大肠生炒咸酸菜	饮食/烹饪/中国烹饪/中国烹饪
大荔带把肘子	饮食/烹饪/中国烹饪/中国烹饪
大蒜烧白鳝	饮食/烹饪/中国烹饪/中国烹饪
大蒜鲶鱼	饮食/烹饪/中国烹饪/中国烹饪
大豆芽荠苨党参猪腰汤	饮食/烹饪/中国烹饪/中国烹饪
大豆荠苨猪腰汤	饮食/烹饪/中国烹饪/中国烹饪
大蹄扒海参	饮食/烹饪/中国烹饪/中国烹饪
大鱼头豆腐汤	饮食/烹饪/中国烹饪/中国烹饪
大黄消脂绿豆汤	饮食/烹饪/中国烹饪/中国烹饪
大黄瓜泡菜	饮食/烹饪/中国烹饪/中国烹饪
定胜糕	饮食/烹饪/中国烹饪/中国烹饪
带子上朝	饮食/烹饪/中国烹饪/中国烹饪
当归枸杞面线	饮食/烹饪/中国烹饪/中国烹饪
当归百合兔	饮食/烹饪/中国烹饪/中国烹饪
得莫利炖活鱼	饮食/烹饪/中国烹饪/中国烹饪
德顺斋	饮食/烹饪/中国烹饪/中国烹饪
打老虎	饮食/烹饪/中国烹饪/中国烹饪
担担鸡	饮食/烹饪/中国烹饪/中国烹饪
朵颐辣子鸡	饮食/烹饪/中国烹饪/中国烹饪
杜仲排骨炖	饮食/烹饪/中国烹饪/中国烹饪
杜仲腰花	饮食/烹饪/中国烹饪/中国烹饪
二回头	饮食/烹饪/中国烹饪/中国烹饪
二锅头	饮食/烹饪/中国烹饪/中国烹饪
二陈礞石粥	饮食/烹饪/中国烹饪/中国烹饪
恩元居	饮食/烹饪/中国烹饪/中国烹饪
恩济堂秋梨膏	饮食/烹饪/中国烹饪/中国烹饪
丰年灌肠	饮食/烹饪/中国烹饪/中国烹饪
丰收龙舟	饮食/烹饪/中国烹饪/中国烹饪
丰胸通草汤	饮食/烹饪/中国烹饪/中国烹饪
佛手三丝	饮食/烹饪/中国烹饪/中国烹饪
佛手凤柳片	饮食/烹饪/中国烹饪/中国烹饪
佛手排骨	饮食/烹饪/中国烹饪/中国烹饪
佛手烩珍鲍片	饮食/烹饪/中国烹饪/中国烹饪
佛手珠子	饮食/烹饪/中国烹饪/中国烹饪
佛跳墙	饮食/烹饪/中国烹饪/中国烹饪
凤凰萝卜	饮食/烹饪/中国烹饪/中国烹饪
凤凰鱼翅	饮食/烹饪/中国烹饪/中国烹饪
凤梨咕噜虾球	饮食/烹饪/中国烹饪/中国烹饪
凤梨咖喱鸡	饮食/烹饪/中国烹饪/中国烹饪
凤梨烩排骨	饮食/烹饪/中国烹饪/中国烹饪
凤梨蟹柳	饮食/烹饪/中国烹饪/中国烹饪
凤爪	饮食/烹饪/中国烹饪/中国烹饪
凤筋龙爪	饮食/烹饪/中国烹饪/中国烹饪
发丝百叶	饮食/烹饪/中国烹饪/中国烹饪
发菜蚝豉汤	饮食/烹饪/中国烹饪/中国烹饪
发财好事	饮食/烹饪/中国烹饪/中国烹饪
复元汤	饮食/烹饪/中国烹饪/中国烹饪
奉化摇蜡	饮食/烹饪/中国烹饪/中国烹饪
富春鸡	饮食/烹饪/中国烹饪/中国烹饪
富贵有鱼	饮食/烹饪/中国烹饪/中国烹饪
富贵满粥	饮食/烹饪/中国烹饪/中国烹饪
枫泾丁蹄	饮食/烹饪/中国烹饪/中国烹饪
光饼	饮食/烹饪/中国烹饪/中国烹饪
咕噜牛排	饮食/烹饪/中国烹饪/中国烹饪
宫保虾球	饮食/烹饪/中国烹饪/中国烹饪
宫保魔芋豆腐	饮食/烹饪/中国烹饪/中国烹饪
宫保鸡	饮食/烹饪/中国烹饪/中国烹饪
宫庭献鱼	饮食/烹饪/中国烹饪/中国烹饪
干姜红茶	饮食/烹饪/中国烹饪/中国烹饪
干火靠大虾	饮食/烹饪/中国烹饪/中国烹饪
干炒牛肉丝	饮食/烹饪/中国烹饪/中国烹饪
干炸丸子	饮食/烹饪/中国烹饪/中国烹饪
干炸平菇	饮食/烹饪/中国烹饪/中国烹饪
干炸蟹枣	饮食/烹饪/中国烹饪/中国烹饪
干炸黄雀	饮食/烹饪/中国烹饪/中国烹饪
干烧大虾	饮食/烹饪/中国烹饪/中国烹饪
干烧明虾球	饮食/烹饪/中国烹饪/中国烹饪
干烧牛筋	饮食/烹饪/中国烹饪/中国烹饪
干烧牛肉片	饮食/烹饪/中国烹饪/中国烹饪
干烧荷包鱼	饮食/烹饪/中国烹饪/中国烹饪
干烧萝卜	饮食/烹饪/中国烹饪/中国烹饪
干烧辽参	饮食/烹饪/中国烹饪/中国烹饪
干烧雅鱼	饮食/烹饪/中国烹饪/中国烹饪
干烧鱼	饮食/烹饪/中国烹饪/中国烹饪
干烧鱼翅	饮食/烹饪/中国烹饪/中国烹饪
干烧鸡翅	饮食/烹饪/中国烹饪/中国烹饪
干煎虾碌	饮食/烹饪/中国烹饪/中国烹饪
干煎黄鱼	饮食/烹饪/中国烹饪/中国烹饪
干煸四季豆	饮食/烹饪/中国烹饪/中国烹饪
干煸扁豆	饮食/烹饪/中国烹饪/中国烹饪
干煸牛腩	饮食/烹饪/中国烹饪/中国烹饪
干煸神仙蟹	饮食/烹饪/中国烹饪/中国烹饪
干煸肉丝	饮食/烹饪/中国烹饪/中国烹饪
干煸苦瓜丝	饮食/烹饪/中国烹饪/中国烹饪
干煸茭白	饮食/烹饪/中国烹饪/中国烹饪
干煸莲藕	饮食/烹饪/中国烹饪/中国烹饪
干煸豇豆	饮食/烹饪/中国烹饪/中国烹饪
干煸香菇扁豆	饮食/烹饪/中国烹饪/中国烹饪
干煸鲜笋	饮食/烹饪/中国烹饪/中国烹饪
干煸鳝背	饮食/烹饪/中国烹饪/中国烹饪
干煸鳝鱼	饮食/烹饪/中国烹饪/中国烹饪
干煸鳝鱼丝	饮食/烹饪/中国烹饪/中国烹饪
干菊花粥	饮食/烹饪/中国烹饪/中国烹饪
干菜焖肉	饮食/烹饪/中国烹饪/中国烹饪
干贝水晶鸡	饮食/烹饪/中国烹饪/中国烹饪
干贝汤	饮食/烹饪/中国烹饪/中国烹饪
干贝萝卜汤	饮食/烹饪/中国烹饪/中国烹饪
干锅手撕包菜	饮食/烹饪/中国烹饪/中国烹饪
干锅腊味河蚌	饮食/烹饪/中国烹饪/中国烹饪
干风春鱼	饮食/烹饪/中国烹饪/中国烹饪
广东油鸡淋酱	饮食/烹饪/中国烹饪/中国烹饪
广州文昌鸡	饮食/烹饪/中国烹饪/中国烹饪
广式滷鸭翅	饮食/烹饪/中国烹饪/中国烹饪
广式香炒面	饮食/烹饪/中国烹饪/中国烹饪
广式香腊焖饭	饮食/烹饪/中国烹饪/中国烹饪
广汉缠丝兔	饮食/烹饪/中国烹饪/中国烹饪
归参山药猪腰	饮食/烹饪/中国烹饪/中国烹饪
归参炖母鸡	饮食/烹饪/中国烹饪/中国烹饪
怪味白肉	饮食/烹饪/中国烹饪/中国烹饪
怪味鲜鱿鱼	饮食/烹饪/中国烹饪/中国烹饪
怪味鸡	饮食/烹饪/中国烹饪/中国烹饪
怪味鸡块	饮食/烹饪/中国烹饪/中国烹饪
挂炉烤鸭	饮食/烹饪/中国烹饪/中国烹饪
挂霜丸子	饮食/烹饪/中国烹饪/中国烹饪
果仁徘骨	饮食/烹饪/中国烹饪/中国烹饪
果仁排骨	饮食/烹饪/中国烹饪/中国烹饪
果汁煎肉脯	饮食/烹饪/中国烹饪/中国烹饪
果汁煎鸡肉	饮食/烹饪/中国烹饪/中国烹饪
果汁肉脯	饮食/烹饪/中国烹饪/中国烹饪
果汁鱼块	饮食/烹饪/中国烹饪/中国烹饪
果汁鲜鱼块	饮食/烹饪/中国烹饪/中国烹饪
果汁鸡条	饮食/烹饪/中国烹饪/中国烹饪
果汁鹌鹑	饮食/烹饪/中国烹饪/中国烹饪
果玉带子	饮食/烹饪/中国烹饪/中国烹饪
果酱三明治	饮食/烹饪/中国烹饪/中国烹饪
枸杞叶羊肾粥	饮食/烹饪/中国烹饪/中国烹饪
枸杞明目排毒汤	饮食/烹饪/中国烹饪/中国烹饪
枸杞海参鸽蛋	饮食/烹饪/中国烹饪/中国烹饪
枸杞牛肝汤	饮食/烹饪/中国烹饪/中国烹饪
枸杞田螺汤	饮食/烹饪/中国烹饪/中国烹饪
枸杞莲子鸡汤	饮食/烹饪/中国烹饪/中国烹饪
枸杞莲心鸡汤	饮食/烹饪/中国烹饪/中国烹饪
枸杞菊花煲排骨	饮食/烹饪/中国烹饪/中国烹饪
枸杞菜猪肝瘦肉汤	饮食/烹饪/中国烹饪/中国烹饪
枸杞蒸鸡	饮食/烹饪/中国烹饪/中国烹饪
枸杞香蛋	饮食/烹饪/中国烹饪/中国烹饪
枸杞鸡汁玉米羹	饮食/烹饪/中国烹饪/中国烹饪
桂圆羊肉煲	饮食/烹饪/中国烹饪/中国烹饪
桂林三宝	饮食/烹饪/中国烹饪/中国烹饪
桂林米粉	饮食/烹饪/中国烹饪/中国烹饪
桂林豆腐乳	饮食/烹饪/中国烹饪/中国烹饪
桂花元宵	饮食/烹饪/中国烹饪/中国烹饪
桂花核桃冻	饮食/烹饪/中国烹饪/中国烹饪
桂花糖大栗	饮食/烹饪/中国烹饪/中国烹饪
桂花肉	饮食/烹饪/中国烹饪/中国烹饪
桂蜜银耳汤	饮食/烹饪/中国烹饪/中国烹饪
何首乌紫菜炖豆腐	饮食/烹饪/中国烹饪/中国烹饪
化积解热饮	饮食/烹饪/中国烹饪/中国烹饪
合菜盖被	饮食/烹饪/中国烹饪/中国烹饪
和味牛杂萝卜	饮食/烹饪/中国烹饪/中国烹饪
回味鱼片	饮食/烹饪/中国烹饪/中国烹饪
回锅牛小排	饮食/烹饪/中国烹饪/中国烹饪
回锅鱼片	饮食/烹饪/中国烹饪/中国烹饪
好丝百叶	饮食/烹饪/中国烹饪/中国烹饪
好味鸡	饮食/烹饪/中国烹饪/中国烹饪
徽州园子	饮食/烹饪/中国烹饪/中国烹饪
徽州状元饭	饮食/烹饪/中国烹饪/中国烹饪
徽菜	饮食/烹饪/中国烹饪/中国烹饪
换心乌贼	饮食/烹饪/中国烹饪/中国烹饪
旱蒸贝母鸡	饮食/烹饪/中国烹饪/中国烹饪
杭三鲜	饮食/烹饪/中国烹饪/中国烹饪
核桃瘦肉海马汤	饮食/烹饪/中国烹饪/中国烹饪
核桃红米饭	饮食/烹饪/中国烹饪/中国烹饪
核桃酪	饮食/烹饪/中国烹饪/中国烹饪
核桃马来糕	饮食/烹饪/中国烹饪/中国烹饪
槐花木耳猪肚汤	饮食/烹饪/中国烹饪/中国烹饪
槐花猪肠汤	饮食/烹饪/中国烹饪/中国烹饪
九仙糕	饮食/烹饪/中国烹饪/中国烹饪
京东肉饼	饮食/烹饪/中国烹饪/中国烹饪
京式酸辣汤	饮食/烹饪/中国烹饪/中国烹饪
京酱牛肉丝便当	饮食/烹饪/中国烹饪/中国烹饪
假芹菜猪肝汤	饮食/烹饪/中国烹饪/中国烹饪
健康十谷米	饮食/烹饪/中国烹饪/中国烹饪
健美茶	饮食/烹饪/中国烹饪/中国烹饪
健胃荞麦茶	饮食/烹饪/中国烹饪/中国烹饪
健脑核桃排骨汤	饮食/烹饪/中国烹饪/中国烹饪
健脑补肾鸡汤	饮食/烹饪/中国烹饪/中国烹饪
决明子粥	饮食/烹饪/中国烹饪/中国烹饪
决明枸杞茶	饮食/烹饪/中国烹饪/中国烹饪
减肥菜谱香菇豆腐	饮食/烹饪/中国烹饪/中国烹饪
减脂健美茶	饮食/烹饪/中国烹饪/中国烹饪
剑花白鳝汤	饮食/烹饪/中国烹饪/中国烹饪
剑花蜜枣猪肺汤	饮食/烹饪/中国烹饪/中国烹饪
剑花马蹄白鳝汤	饮食/烹饪/中国烹饪/中国烹饪
加味二妙散	饮食/烹饪/中国烹饪/中国烹饪
加积鸭	饮食/烹饪/中国烹饪/中国烹饪
卷心菜洋葱汁	饮食/烹饪/中国烹饪/中国烹饪
及第粥	饮食/烹饪/中国烹饪/中国烹饪
叫化仔鸡	饮食/烹饪/中国烹饪/中国烹饪
吉列海鲜卷	饮食/烹饪/中国烹饪/中国烹饪
吉利大虾	饮食/烹饪/中国烹饪/中国烹饪
吉利虾	饮食/烹饪/中国烹饪/中国烹饪
吉利豆饼	饮食/烹饪/中国烹饪/中国烹饪
吉菜	饮食/烹饪/中国烹饪/中国烹饪
嘉士伯啤酒	饮食/烹饪/中国烹饪/中国烹饪
均安蒸猪	饮食/烹饪/中国烹饪/中国烹饪
坚齿消炎茶	饮食/烹饪/中国烹饪/中国烹饪
姜丝排叉	饮食/烹饪/中国烹饪/中国烹饪
姜丝焗肉蟹	饮食/烹饪/中国烹饪/中国烹饪
姜丝牛肉	饮食/烹饪/中国烹饪/中国烹饪
姜丝肉蟹	饮食/烹饪/中国烹饪/中国烹饪
姜拌藕	饮食/烹饪/中国烹饪/中国烹饪
姜汁仔鸡	饮食/烹饪/中国烹饪/中国烹饪
姜汁刀豆	饮食/烹饪/中国烹饪/中国烹饪
姜汁拌菠菜	饮食/烹饪/中国烹饪/中国烹饪
姜汁排叉	饮食/烹饪/中国烹饪/中国烹饪
姜汁热味鸡	饮食/烹饪/中国烹饪/中国烹饪
姜汁热窝鸡	饮食/烹饪/中国烹饪/中国烹饪
姜汁菠菜	饮食/烹饪/中国烹饪/中国烹饪
姜汁赤贝	饮食/烹饪/中国烹饪/中国烹饪
姜汁饼	饮食/烹饪/中国烹饪/中国烹饪
姜汁鸭掌	饮食/烹饪/中国烹饪/中国烹饪
姜艾鸡蛋	饮食/烹饪/中国烹饪/中国烹饪
姜茶乌梅粥	饮食/烹饪/中国烹饪/中国烹饪
姜葱基围虾	饮食/烹饪/中国烹饪/中国烹饪
姜葱炒蟹	饮食/烹饪/中国烹饪/中国烹饪
姜葱煀鲤鱼	饮食/烹饪/中国烹饪/中国烹饪
姜葱蚬芥蒸鱼云	饮食/烹饪/中国烹饪/中国烹饪
姜葱螃蟹	饮食/烹饪/中国烹饪/中国烹饪
姜醋白切蟹	饮食/烹饪/中国烹饪/中国烹饪
家乡南肉	饮食/烹饪/中国烹饪/中国烹饪
家乡肉	饮食/烹饪/中国烹饪/中国烹饪
家乡芝士蛋糕	饮食/烹饪/中国烹饪/中国烹饪
家常海参	饮食/烹饪/中国烹饪/中国烹饪
家常烤鸡	饮食/烹饪/中国烹饪/中国烹饪
家常熬鱼	饮食/烹饪/中国烹饪/中国烹饪
家常狗肉	饮食/烹饪/中国烹饪/中国烹饪
家常红烧茄子	饮食/烹饪/中国烹饪/中国烹饪
家常绍子鱼	饮食/烹饪/中国烹饪/中国烹饪
家常豆腐	饮食/烹饪/中国烹饪/中国烹饪
尖椒肉丝	饮食/烹饪/中国烹饪/中国烹饪
旧州鸡辣子	饮食/烹饪/中国烹饪/中国烹饪
晶糕肉片	饮食/烹饪/中国烹饪/中国烹饪
桔烧巴	饮食/烹饪/中国烹饪/中国烹饪
桔瓣广昌莲	饮食/烹饪/中国烹饪/中国烹饪
桔瓣鱼汆	饮食/烹饪/中国烹饪/中国烹饪
桔络丸子	饮食/烹饪/中国烹饪/中国烹饪
桔香红枣茶	饮食/烹饪/中国烹饪/中国烹饪
椒油扁豆	饮食/烹饪/中国烹饪/中国烹饪
椒油炝芹菜	饮食/烹饪/中国烹饪/中国烹饪
椒盐八宝鸡	饮食/烹饪/中国烹饪/中国烹饪
椒盐炸鸡块	饮食/烹饪/中国烹饪/中国烹饪
椒盐竹仔鱼	饮食/烹饪/中国烹饪/中国烹饪
椒盐肚尖	饮食/烹饪/中国烹饪/中国烹饪
椒盐花生	饮食/烹饪/中国烹饪/中国烹饪
椒盐蹄膀	饮食/烹饪/中国烹饪/中国烹饪
椒附炖猪肚	饮食/烹饪/中国烹饪/中国烹饪
椒麻鸡	饮食/烹饪/中国烹饪/中国烹饪
椒麻鸡片	饮食/烹饪/中国烹饪/中国烹饪
卡夫果丝春卷	饮食/烹饪/中国烹饪/中国烹饪
口味蛇	饮食/烹饪/中国烹饪/中国烹饪
口味鳝片	饮食/烹饪/中国烹饪/中国烹饪
口水鸡	饮食/烹饪/中国烹饪/中国烹饪
口福鸡	饮食/烹饪/中国烹饪/中国烹饪
口蘑扒鱼脯	饮食/烹饪/中国烹饪/中国烹饪
口蘑蒸鸡	饮食/烹饪/中国烹饪/中国烹饪
口袋豆腐	饮食/烹饪/中国烹饪/中国烹饪
可可豆	饮食/烹饪/中国烹饪/中国烹饪
咖哩牛肉	饮食/烹饪/中国烹饪/中国烹饪
咖哩草菇	饮食/烹饪/中国烹饪/中国烹饪
咖哩起司法国面包	饮食/烹饪/中国烹饪/中国烹饪
咖哩鸡	饮食/烹饪/中国烹饪/中国烹饪
咖喱	饮食/烹饪/中国烹饪/中国烹饪
咖喱大豆烩肉	饮食/烹饪/中国烹饪/中国烹饪
咖喱樱桃	饮食/烹饪/中国烹饪/中国烹饪
咖喱油烟虾段	饮食/烹饪/中国烹饪/中国烹饪
咖喱炒干丝	饮食/烹饪/中国烹饪/中国烹饪
咖喱焖羊腩	饮食/烹饪/中国烹饪/中国烹饪
咖喱焖鸡	饮食/烹饪/中国烹饪/中国烹饪
咖喱牛排	饮食/烹饪/中国烹饪/中国烹饪
咖喱牛百叶汤	饮食/烹饪/中国烹饪/中国烹饪
咖喱饺	饮食/烹饪/中国烹饪/中国烹饪
咖喱鸡	饮食/烹饪/中国烹饪/中国烹饪
咖喱鸡丝羹	饮食/烹饪/中国烹饪/中国烹饪
孔府菜	饮食/烹饪/中国烹饪/中国烹饪
客家三杯鸡	饮食/烹饪/中国烹饪/中国烹饪
客家咸汤元	饮食/烹饪/中国烹饪/中国烹饪
客家封鸡	饮食/烹饪/中国烹饪/中国烹饪
开屏柴把脆肚	饮食/烹饪/中国烹饪/中国烹饪
开水白菜	饮食/烹饪/中国烹饪/中国烹饪
开洋萝卜丝汤	饮食/烹饪/中国烹饪/中国烹饪
开洋葱油拌面	饮食/烹饪/中国烹饪/中国烹饪
开胃水鱼	饮食/烹饪/中国烹饪/中国烹饪
扛糟羊肉	饮食/烹饪/中国烹饪/中国烹饪
扛糟鸡	饮食/烹饪/中国烹饪/中国烹饪
扣四丝	饮食/烹饪/中国烹饪/中国烹饪
扣环球上汤	饮食/烹饪/中国烹饪/中国烹饪
扣碗酥肉	饮食/烹饪/中国烹饪/中国烹饪
扣鸡	饮食/烹饪/中国烹饪/中国烹饪
昆布海澡瘦肉汤	饮食/烹饪/中国烹饪/中国烹饪
昆布海藻煲黄豆汤	饮食/烹饪/中国烹饪/中国烹饪
两吃菠菜	饮食/烹饪/中国烹饪/中国烹饪
两情相悦	饮食/烹饪/中国烹饪/中国烹饪
伦教糕	饮食/烹饪/中国烹饪/中国烹饪
六百居香肠粉肚	饮食/烹饪/中国烹饪/中国烹饪
兰度鸽脯	饮食/烹饪/中国烹饪/中国烹饪
兰花八宝冬瓜	饮食/烹饪/中国烹饪/中国烹饪
兰花春笋	饮食/烹饪/中国烹饪/中国烹饪
兰花金针	饮食/烹饪/中国烹饪/中国烹饪
兰花金钱酿发菜	饮食/烹饪/中国烹饪/中国烹饪
冷啖杯	饮食/烹饪/中国烹饪/中国烹饪
冷拼	饮食/烹饪/中国烹饪/中国烹饪
凉拌三色	饮食/烹饪/中国烹饪/中国烹饪
凉拌冬瓜	饮食/烹饪/中国烹饪/中国烹饪
凉拌四宝	饮食/烹饪/中国烹饪/中国烹饪
凉拌牛蒡	饮食/烹饪/中国烹饪/中国烹饪
凉拌白萝卜丝	饮食/烹饪/中国烹饪/中国烹饪
凉拌芝麻秋葵	饮食/烹饪/中国烹饪/中国烹饪
凉拌茭白	饮食/烹饪/中国烹饪/中国烹饪
凉拌藕片	饮食/烹饪/中国烹饪/中国烹饪
凉拌西瓜皮	饮食/烹饪/中国烹饪/中国烹饪
凉拌豆腐	饮食/烹饪/中国烹饪/中国烹饪
凉拌豇豆	饮食/烹饪/中国烹饪/中国烹饪
凉拌辣味螺	饮食/烹饪/中国烹饪/中国烹饪
凉拌馄饨皮	饮食/烹饪/中国烹饪/中国烹饪
凉拌鸡丝	饮食/烹饪/中国烹饪/中国烹饪
凉拌鸭赏	饮食/烹饪/中国烹饪/中国烹饪
凉拌鹅肉	饮食/烹饪/中国烹饪/中国烹饪
凉瓜排骨	饮食/烹饪/中国烹饪/中国烹饪
凉瓜浸田鸡	饮食/烹饪/中国烹饪/中国烹饪
凉瓜牛肉丝	饮食/烹饪/中国烹饪/中国烹饪
凉瓜肉排汤	饮食/烹饪/中国烹饪/中国烹饪
凉粉	饮食/烹饪/中国烹饪/中国烹饪
凉粉鲫鱼	饮食/烹饪/中国烹饪/中国烹饪
凉菜大拉皮	饮食/烹饪/中国烹饪/中国烹饪
凉面饼子	饮食/烹饪/中国烹饪/中国烹饪
卤汁冬菇	饮食/烹饪/中国烹饪/中国烹饪
卤汁豆干	饮食/烹饪/中国烹饪/中国烹饪
卤煮张	饮食/烹饪/中国烹饪/中国烹饪
卤瓜氽黄鱼	饮食/烹饪/中国烹饪/中国烹饪
卤豆腐	饮食/烹饪/中国烹饪/中国烹饪
卤鸡肝	饮食/烹饪/中国烹饪/中国烹饪
厉家菜	饮食/烹饪/中国烹饪/中国烹饪
恋爱豆腐	饮食/烹饪/中国烹饪/中国烹饪
拉糟鱼块	饮食/烹饪/中国烹饪/中国烹饪
晾肉	饮食/烹饪/中国烹饪/中国烹饪
李记白水羊头	饮食/烹饪/中国烹饪/中国烹饪
栗子淮山猪蹄汤	饮食/烹饪/中国烹饪/中国烹饪
栗子炒子鸡	饮食/烹饪/中国烹饪/中国烹饪
栗子焖羊肉	饮食/烹饪/中国烹饪/中国烹饪
栗子白菜	饮食/烹饪/中国烹饪/中国烹饪
栗子糕	饮食/烹饪/中国烹饪/中国烹饪
栗子莲子猪腰汤	饮食/烹饪/中国烹饪/中国烹饪
栗子黄焖鸡	饮食/烹饪/中国烹饪/中国烹饪
榴莲鲜鸡汤	饮食/烹饪/中国烹饪/中国烹饪
么么喳喳珍珠糖水	饮食/烹饪/中国烹饪/中国烹饪
墨西哥水饺片	饮食/烹饪/中国烹饪/中国烹饪
墨西哥鸡翅	饮食/烹饪/中国烹饪/中国烹饪
密制烤河鳗	饮食/烹饪/中国烹饪/中国烹饪
明炉梅子鸭	饮食/烹饪/中国烹饪/中国烹饪
木桶辣子虾	饮食/烹饪/中国烹饪/中国烹饪
木瓜墨鱼汤	饮食/烹饪/中国烹饪/中国烹饪
木瓜带鱼汤	饮食/烹饪/中国烹饪/中国烹饪
木瓜煲老鸭	饮食/烹饪/中国烹饪/中国烹饪
木瓜生鱼汤	饮食/烹饪/中国烹饪/中国烹饪
木瓜辽参	饮食/烹饪/中国烹饪/中国烹饪
木耳炒肉片	饮食/烹饪/中国烹饪/中国烹饪
木耳红枣粥	饮食/烹饪/中国烹饪/中国烹饪
木耳顺风	饮食/烹饪/中国烹饪/中国烹饪
木耳黄瓜	饮食/烹饪/中国烹饪/中国烹饪
梅子肉	饮食/烹饪/中国烹饪/中国烹饪
梅子豉椒蟹	饮食/烹饪/中国烹饪/中国烹饪
梅干菜烧肉	饮食/烹饪/中国烹饪/中国烹饪
梅林里脊	饮食/烹饪/中国烹饪/中国烹饪
梅花粥	饮食/烹饪/中国烹饪/中国烹饪
南乳笋鸡	饮食/烹饪/中国烹饪/中国烹饪
南乳羊腿	饮食/烹饪/中国烹饪/中国烹饪
南乳肉	饮食/烹饪/中国烹饪/中国烹饪
南北杏	饮食/烹饪/中国烹饪/中国烹饪
南北杏仁鹌鹑汤	饮食/烹饪/中国烹饪/中国烹饪
南排杂烩	饮食/烹饪/中国烹饪/中国烹饪
南来顺	饮食/烹饪/中国烹饪/中国烹饪
南湖蟹粉	饮食/烹饪/中国烹饪/中国烹饪
南煎肝	饮食/烹饪/中国烹饪/中国烹饪
南瓜	饮食/烹饪/中国烹饪/中国烹饪
南瓜冰糖水	饮食/烹饪/中国烹饪/中国烹饪
南瓜咕老虾	饮食/烹饪/中国烹饪/中国烹饪
南瓜汤	饮食/烹饪/中国烹饪/中国烹饪
南瓜炒虾米	饮食/烹饪/中国烹饪/中国烹饪
南瓜百合爽	饮食/烹饪/中国烹饪/中国烹饪
南瓜红枣排骨汤	饮食/烹饪/中国烹饪/中国烹饪
南瓜花粥	饮食/烹饪/中国烹饪/中国烹饪
南瓜蒸肉	饮食/烹饪/中国烹饪/中国烹饪
南瓶晚钟	饮食/烹饪/中国烹饪/中国烹饪
南肉春笋	饮食/烹饪/中国烹饪/中国烹饪
南荠烧鸭丁	饮食/烹饪/中国烹饪/中国烹饪
南荠草莓饼	饮食/烹饪/中国烹饪/中国烹饪
南豆花淡竹叶猪展汤	饮食/烹饪/中国烹饪/中国烹饪
奶味芦笋汤	饮食/烹饪/中国烹饪/中国烹饪
奶汁回王鱼	饮食/烹饪/中国烹饪/中国烹饪
奶汁海带	饮食/烹饪/中国烹饪/中国烹饪
奶汤散丹	饮食/烹饪/中国烹饪/中国烹饪
奶汤棱桃仁	饮食/烹饪/中国烹饪/中国烹饪
奶汤火腿大鱼头	饮食/烹饪/中国烹饪/中国烹饪
奶汤白菜	饮食/烹饪/中国烹饪/中国烹饪
奶汤鲜核桃仁	饮食/烹饪/中国烹饪/中国烹饪
奶汤鸡脯	饮食/烹饪/中国烹饪/中国烹饪
奶油扒菜芯	饮食/烹饪/中国烹饪/中国烹饪
奶油桂鱼	饮食/烹饪/中国烹饪/中国烹饪
奶油炸糕	饮食/烹饪/中国烹饪/中国烹饪
奶油烤白菜	饮食/烹饪/中国烹饪/中国烹饪
奶油玉米笋	饮食/烹饪/中国烹饪/中国烹饪
奶油瓜菇汤	饮食/烹饪/中国烹饪/中国烹饪
奶油莲花白	饮食/烹饪/中国烹饪/中国烹饪
奶油蟹肉	饮食/烹饪/中国烹饪/中国烹饪
奶油西兰花	饮食/烹饪/中国烹饪/中国烹饪
奶豆腐	饮食/烹饪/中国烹饪/中国烹饪
奶酪魏	饮食/烹饪/中国烹饪/中国烹饪
奶香菠菜	饮食/烹饪/中国烹饪/中国烹饪
奶鱼煮菜心	饮食/烹饪/中国烹饪/中国烹饪
娘娘爱	饮食/烹饪/中国烹饪/中国烹饪
嫩姜子鸭片	饮食/烹饪/中国烹饪/中国烹饪
嫩豇豆汤	饮食/烹饪/中国烹饪/中国烹饪
宁氏鳝丝	饮食/烹饪/中国烹饪/中国烹饪
宁波烧鹅	饮食/烹饪/中国烹饪/中国烹饪
年糕钱	饮食/烹饪/中国烹饪/中国烹饪
暖胃润肤茶	饮食/烹饪/中国烹饪/中国烹饪
柠檬鸡	饮食/烹饪/中国烹饪/中国烹饪
柠檬黄瓜条	饮食/烹饪/中国烹饪/中国烹饪
柠汁炸软鸡	饮食/烹饪/中国烹饪/中国烹饪
柠汁焗鹌鹑	饮食/烹饪/中国烹饪/中国烹饪
柠香洛神茶	饮食/烹饪/中国烹饪/中国烹饪
啤酒椒麻鸡	饮食/烹饪/中国烹饪/中国烹饪
啤酒蟹	饮食/烹饪/中国烹饪/中国烹饪
培养正气鸡块	饮食/烹饪/中国烹饪/中国烹饪
培根丝瓜煎蛋	饮食/烹饪/中国烹饪/中国烹饪
培根蔬菜卷	饮食/烹饪/中国烹饪/中国烹饪
平安茶	饮食/烹饪/中国烹饪/中国烹饪
平桥豆腐	饮食/烹饪/中国烹饪/中国烹饪
平湖糟蛋	饮食/烹饪/中国烹饪/中国烹饪
平菇蛋汤	饮食/烹饪/中国烹饪/中国烹饪
彭集红烧肘子	饮食/烹饪/中国烹饪/中国烹饪
枇杷叶苡仁粥	饮食/烹饪/中国烹饪/中国烹饪
枇杷叶菊花蜜茶	饮食/烹饪/中国烹饪/中国烹饪
枇杷虾	饮食/烹饪/中国烹饪/中国烹饪
七彩什锦煲	饮食/烹饪/中国烹饪/中国烹饪
七星丸	饮食/烹饪/中国烹饪/中国烹饪
乾坤蒸狗	饮食/烹饪/中国烹饪/中国烹饪
全丝烩鱼翅	饮食/烹饪/中国烹饪/中国烹饪
千岛汁鸡球	饮食/烹饪/中国烹饪/中国烹饪
千张肉	饮食/烹饪/中国烹饪/中国烹饪
岐山臊子面	饮食/烹饪/中国烹饪/中国烹饪
巧克力沙司	饮食/烹饪/中国烹饪/中国烹饪
庆丰包子铺	饮食/烹饪/中国烹饪/中国烹饪
掐菜炒鸡丝	饮食/烹饪/中国烹饪/中国烹饪
敲鱼	饮食/烹饪/中国烹饪/中国烹饪
杞子南枣煲鸡蛋	饮食/烹饪/中国烹饪/中国烹饪
杞子桂圆海鱼汤	饮食/烹饪/中国烹饪/中国烹饪
杞子牛肝汤	饮食/烹饪/中国烹饪/中国烹饪
杞忧烘皮肘	饮食/烹饪/中国烹饪/中国烹饪
RNA聚合酶	饮食/烹饪/中国烹饪/中国烹饪
乳椒空心菜	饮食/烹饪/中国烹饪/中国烹饪
乳酪蒸虾仁	饮食/烹饪/中国烹饪/中国烹饪
人参升麻粥	饮食/烹饪/中国烹饪/中国烹饪
人参地黄炖蜜糖	饮食/烹饪/中国烹饪/中国烹饪
人参核桃仁粥	饮食/烹饪/中国烹饪/中国烹饪
人参莲子粥	饮食/烹饪/中国烹饪/中国烹饪
人参鲫鱼粥	饮食/烹饪/中国烹饪/中国烹饪
如意豆腐卷	饮食/烹饪/中国烹饪/中国烹饪
日本拉面	饮食/烹饪/中国烹饪/中国烹饪
三丁包	饮食/烹饪/中国烹饪/中国烹饪
三丁大包	饮食/烹饪/中国烹饪/中国烹饪
三丁烩虾仁	饮食/烹饪/中国烹饪/中国烹饪
三七乌骨鸡	饮食/烹饪/中国烹饪/中国烹饪
三丝拌糟鸡	饮食/烹饪/中国烹饪/中国烹饪
三丝敲鱼	饮食/烹饪/中国烹饪/中国烹饪
三丝清炒蟹	饮食/烹饪/中国烹饪/中国烹饪
三丝燕菜	饮食/烹饪/中国烹饪/中国烹饪
三丝牛肉卷	饮食/烹饪/中国烹饪/中国烹饪
三丝鱼翅	饮食/烹饪/中国烹饪/中国烹饪
三丝鱿鱼	饮食/烹饪/中国烹饪/中国烹饪
三仙通草汤	饮食/烹饪/中国烹饪/中国烹饪
三冬肉片	饮食/烹饪/中国烹饪/中国烹饪
三味玉翡翠	饮食/烹饪/中国烹饪/中国烹饪
三味薏米羹	饮食/烹饪/中国烹饪/中国烹饪
三味豆腐	饮食/烹饪/中国烹饪/中国烹饪
三宝酱虾	饮食/烹饪/中国烹饪/中国烹饪
三彩菠菜	饮食/烹饪/中国烹饪/中国烹饪
三文一品汤包	饮食/烹饪/中国烹饪/中国烹饪
三文鱼馅饺子	饮食/烹饪/中国烹饪/中国烹饪
三杯鸡	饮食/烹饪/中国烹饪/中国烹饪
三沙粿仔	饮食/烹饪/中国烹饪/中国烹饪
三皮丝	饮食/烹饪/中国烹饪/中国烹饪
三色开花馒头	饮食/烹饪/中国烹饪/中国烹饪
三色杂烩粥	饮食/烹饪/中国烹饪/中国烹饪
三色蛋	饮食/烹饪/中国烹饪/中国烹饪
三色鱼丸汤	饮食/烹饪/中国烹饪/中国烹饪
三色鸡丁	饮食/烹饪/中国烹饪/中国烹饪
三色龙虾	饮食/烹饪/中国烹饪/中国烹饪
三菇浸鱼云	饮食/烹饪/中国烹饪/中国烹饪
三菌炖鸡	饮食/烹饪/中国烹饪/中国烹饪
三虾豆腐	饮食/烹饪/中国烹饪/中国烹饪
三雪蚌花瘦肉汤	饮食/烹饪/中国烹饪/中国烹饪
三鲜冰豆腐	饮食/烹饪/中国烹饪/中国烹饪
三鲜水饺	饮食/烹饪/中国烹饪/中国烹饪
三鲜玉米羹	饮食/烹饪/中国烹饪/中国烹饪
三鲜砂锅	饮食/烹饪/中国烹饪/中国烹饪
三鲜素鱼肚	饮食/烹饪/中国烹饪/中国烹饪
三鲜苦瓜汤	饮食/烹饪/中国烹饪/中国烹饪
三鲜茄子	饮食/烹饪/中国烹饪/中国烹饪
三鲜蘑菇	饮食/烹饪/中国烹饪/中国烹饪
三鲜豆腐盒	饮食/烹饪/中国烹饪/中国烹饪
三鲜酿面筋	饮食/烹饪/中国烹饪/中国烹饪
三鲜锅巴	饮食/烹饪/中国烹饪/中国烹饪
三鲜锅粑	饮食/烹饪/中国烹饪/中国烹饪
上汤奶白菜	饮食/烹饪/中国烹饪/中国烹饪
上汤鸡毛菜	饮食/烹饪/中国烹饪/中国烹饪
上素仙鹤	饮食/烹饪/中国烹饪/中国烹饪
丝娃娃	饮食/烹饪/中国烹饪/中国烹饪
丝瓜炖豆腐	饮食/烹饪/中国烹饪/中国烹饪
丝瓜猪肝瘦肉汤	饮食/烹饪/中国烹饪/中国烹饪
丝瓜白菜猪瘦肉汤	饮食/烹饪/中国烹饪/中国烹饪
丝瓜百合猪肝汤	饮食/烹饪/中国烹饪/中国烹饪
丝瓜草菇滚鲮鱼球汤	饮食/烹饪/中国烹饪/中国烹饪
事事平安	饮食/烹饪/中国烹饪/中国烹饪
什锦一品锅	饮食/烹饪/中国烹饪/中国烹饪
什锦冬瓜帽	饮食/烹饪/中国烹饪/中国烹饪
什锦味噌锅	饮食/烹饪/中国烹饪/中国烹饪
什锦暖锅	饮食/烹饪/中国烹饪/中国烹饪
什锦果汁饭	饮食/烹饪/中国烹饪/中国烹饪
什锦水果羔	饮食/烹饪/中国烹饪/中国烹饪
什锦海参	饮食/烹饪/中国烹饪/中国烹饪
什锦烩豆腐	饮食/烹饪/中国烹饪/中国烹饪
什锦烩饭	饮食/烹饪/中国烹饪/中国烹饪
什锦蔬菜冻	饮食/烹饪/中国烹饪/中国烹饪
什锦蛋卷	饮食/烹饪/中国烹饪/中国烹饪
什锦蜂窝豆腐	饮食/烹饪/中国烹饪/中国烹饪
什锦豆腐汤	饮食/烹饪/中国烹饪/中国烹饪
什锦豆腐煲	饮食/烹饪/中国烹饪/中国烹饪
什锦锅巴	饮食/烹饪/中国烹饪/中国烹饪
什锦面片汤	饮食/烹饪/中国烹饪/中国烹饪
什锦麦片	饮食/烹饪/中国烹饪/中国烹饪
什锦麦胚饼	饮食/烹饪/中国烹饪/中国烹饪
十全炆补汤	饮食/烹饪/中国烹饪/中国烹饪
十八街大麻花	饮食/烹饪/中国烹饪/中国烹饪
双仁浮皮	饮食/烹饪/中国烹饪/中国烹饪
双仁猪展汤	饮食/烹饪/中国烹饪/中国烹饪
双冬烧茄子	饮食/烹饪/中国烹饪/中国烹饪
双参羊肉锅	饮食/烹饪/中国烹饪/中国烹饪
双味蹄筋	饮食/烹饪/中国烹饪/中国烹饪
双椒小炒兔	饮食/烹饪/中国烹饪/中国烹饪
双椒鸡	饮食/烹饪/中国烹饪/中国烹饪
双色玫瑰鱼	饮食/烹饪/中国烹饪/中国烹饪
双色蛋菇	饮食/烹饪/中国烹饪/中国烹饪
双花豆芽汤	饮食/烹饪/中国烹饪/中国烹饪
双花饮	饮食/烹饪/中国烹饪/中国烹饪
双鱼茄子	饮食/烹饪/中国烹饪/中国烹饪
双黄鱼片	饮食/烹饪/中国烹饪/中国烹饪
四件焖冬笋	饮食/烹饪/中国烹饪/中国烹饪
四味山药膏	饮食/烹饪/中国烹饪/中国烹饪
四喜丸子	饮食/烹饪/中国烹饪/中国烹饪
四喜鸭子	饮食/烹饪/中国烹饪/中国烹饪
四喜黄豆粒	饮食/烹饪/中国烹饪/中国烹饪
四季美汤包	饮食/烹饪/中国烹饪/中国烹饪
四宝上汤	饮食/烹饪/中国烹饪/中国烹饪
四川泡大蒜	饮食/烹饪/中国烹饪/中国烹饪
四川泡菜	饮食/烹饪/中国烹饪/中国烹饪
四样荤素	饮食/烹饪/中国烹饪/中国烹饪
四神煲豆腐	饮食/烹饪/中国烹饪/中国烹饪
四鲜烤麸	饮食/烹饪/中国烹饪/中国烹饪
四鲜白菜墩	饮食/烹饪/中国烹饪/中国烹饪
圣女翡翠菠菜汁浓汤	饮食/烹饪/中国烹饪/中国烹饪
宋嫂鱼羹	饮食/烹饪/中国烹饪/中国烹饪
寿星桔蜜饯	饮食/烹饪/中国烹饪/中国烹饪
山东煎饼	饮食/烹饪/中国烹饪/中国烹饪
山东白菜泡菜	饮食/烹饪/中国烹饪/中国烹饪
山东菜丸	饮食/烹饪/中国烹饪/中国烹饪
山城小汤圆	饮食/烹饪/中国烹饪/中国烹饪
山城棒棒鸡	饮食/烹饪/中国烹饪/中国烹饪
山城第一腿	饮食/烹饪/中国烹饪/中国烹饪
山峡风味烤鱼	饮食/烹饪/中国烹饪/中国烹饪
山柿炖羊肉	饮食/烹饪/中国烹饪/中国烹饪
山楂凉茶	饮食/烹饪/中国烹饪/中国烹饪
山楂扁豆金银肾汤	饮食/烹饪/中国烹饪/中国烹饪
山楂核桃茶	饮食/烹饪/中国烹饪/中国烹饪
山楂水	饮食/烹饪/中国烹饪/中国烹饪
山楂洛神纤体茶	饮食/烹饪/中国烹饪/中国烹饪
山楂牛肉干	饮食/烹饪/中国烹饪/中国烹饪
山楂荷叶茶	饮食/烹饪/中国烹饪/中国烹饪
山水特色骨头煲	饮食/烹饪/中国烹饪/中国烹饪
山甲田鸡片	饮食/烹饪/中国烹饪/中国烹饪
山药炒虾仁	饮食/烹饪/中国烹饪/中国烹饪
山药煮豆腐	饮食/烹饪/中国烹饪/中国烹饪
山药甜汤	饮食/烹饪/中国烹饪/中国烹饪
山药百合大枣粥	饮食/烹饪/中国烹饪/中国烹饪
山药蒸鲫鱼	饮食/烹饪/中国烹饪/中国烹饪
山药薏仁茯苓粳米粥	饮食/烹饪/中国烹饪/中国烹饪
山药虾仁豆腐	饮食/烹饪/中国烹饪/中国烹饪
山药鲜百烩	饮食/烹饪/中国烹饪/中国烹饪
山药鲫鱼豆腐汤	饮食/烹饪/中国烹饪/中国烹饪
山萸肉合桃乌鸡汤	饮食/烹饪/中国烹饪/中国烹饪
山蓝猪瘦肉汤	饮食/烹饪/中国烹饪/中国烹饪
手抓羊肉	饮食/烹饪/中国烹饪/中国烹饪
手撕干鱼仔	饮食/烹饪/中国烹饪/中国烹饪
手撕牛肉	饮食/烹饪/中国烹饪/中国烹饪
松仁粉丝	饮食/烹饪/中国烹饪/中国烹饪
松子仁米粥	饮食/烹饪/中国烹饪/中国烹饪
松子河虾仁	饮食/烹饪/中国烹饪/中国烹饪
松子茄鱼	饮食/烹饪/中国烹饪/中国烹饪
松脆海蜇皮	饮食/烹饪/中国烹饪/中国烹饪
松花淡菜粥	饮食/烹饪/中国烹饪/中国烹饪
松蘑	饮食/烹饪/中国烹饪/中国烹饪
松鼠桂鱼	饮食/烹饪/中国烹饪/中国烹饪
松鼠鳜鱼	饮食/烹饪/中国烹饪/中国烹饪
柿椒炒嫩玉米	饮食/烹饪/中国烹饪/中国烹饪
树花炖土鸡	饮食/烹饪/中国烹饪/中国烹饪
桑椹红枣汤	饮食/烹饪/中国烹饪/中国烹饪
桑菊元气茶	饮食/烹饪/中国烹饪/中国烹饪
桑菊杏仁粥	饮食/烹饪/中国烹饪/中国烹饪
桑葚粥	饮食/烹饪/中国烹饪/中国烹饪
桑葚芝麻粥	饮食/烹饪/中国烹饪/中国烹饪
桑葚醪	饮食/烹饪/中国烹饪/中国烹饪
兔肉炖鸡脚	饮食/烹饪/中国烹饪/中国烹饪
兔肝鸡蛋汤	饮食/烹饪/中国烹饪/中国烹饪
台式三杯鸡	饮食/烹饪/中国烹饪/中国烹饪
土家掉渣烧饼	饮食/烹饪/中国烹饪/中国烹饪
土家蒸肉	饮食/烹饪/中国烹饪/中国烹饪
土豆排骨汤	饮食/烹饪/中国烹饪/中国烹饪
土豆烧肉	饮食/烹饪/中国烹饪/中国烹饪
土豆粉	饮食/烹饪/中国烹饪/中国烹饪
土豆罐焖鸡	饮食/烹饪/中国烹饪/中国烹饪
土豆饼	饮食/烹饪/中国烹饪/中国烹饪
坛子肉	饮食/烹饪/中国烹饪/中国烹饪
天波罗	饮食/烹饪/中国烹饪/中国烹饪
天麻鲍鱼汤	饮食/烹饪/中国烹饪/中国烹饪
太子参无花果瘦肉汤	饮食/烹饪/中国烹饪/中国烹饪
太子参百合田鸡汤	饮食/烹饪/中国烹饪/中国烹饪
太极芋头	饮食/烹饪/中国烹饪/中国烹饪
太极鱼翅	饮食/烹饪/中国烹饪/中国烹饪
太爷鸡	饮食/烹饪/中国烹饪/中国烹饪
套四宝	饮食/烹饪/中国烹饪/中国烹饪
屯溪醉蟹	饮食/烹饪/中国烹饪/中国烹饪
提丝发糕	饮食/烹饪/中国烹饪/中国烹饪
桃仁桂鱼	饮食/烹饪/中国烹饪/中国烹饪
桃仁饮	饮食/烹饪/中国烹饪/中国烹饪
桃子色拉	饮食/烹饪/中国烹饪/中国烹饪
桃杞鸡卷	饮食/烹饪/中国烹饪/中国烹饪
桃浆羹	饮食/烹饪/中国烹饪/中国烹饪
桃花鸡腿	饮食/烹饪/中国烹饪/中国烹饪
桃酥鸡糕	饮食/烹饪/中国烹饪/中国烹饪
万子酥鸭	饮食/烹饪/中国烹饪/中国烹饪
乌发仙人粥	饮食/烹饪/中国烹饪/中国烹饪
乌头当归液	饮食/烹饪/中国烹饪/中国烹饪
乌梅抗敏茶	饮食/烹饪/中国烹饪/中国烹饪
乌梅桂花蜜	饮食/烹饪/中国烹饪/中国烹饪
乌米饭	饮食/烹饪/中国烹饪/中国烹饪
乌骨鸡	饮食/烹饪/中国烹饪/中国烹饪
乌骨鸡归黄汤	饮食/烹饪/中国烹饪/中国烹饪
五加皮牛肉烧	饮食/烹饪/中国烹饪/中国烹饪
五加皮瘦肉粥	饮食/烹饪/中国烹饪/中国烹饪
五味煎蟹	饮食/烹饪/中国烹饪/中国烹饪
五味白肉	饮食/烹饪/中国烹饪/中国烹饪
五味百烩	饮食/烹饪/中国烹饪/中国烹饪
五夫醉鸡	饮食/烹饪/中国烹饪/中国烹饪
五子毛桃煲鸡	饮食/烹饪/中国烹饪/中国烹饪
五彩小炒	饮食/烹饪/中国烹饪/中国烹饪
五彩炒蛇丝	饮食/烹饪/中国烹饪/中国烹饪
五彩焗鱼	饮食/烹饪/中国烹饪/中国烹饪
五彩牛肉丝	饮食/烹饪/中国烹饪/中国烹饪
五彩虾松	饮食/烹饪/中国烹饪/中国烹饪
五彩蟹盒	饮食/烹饪/中国烹饪/中国烹饪
五柳全鱼	饮食/烹饪/中国烹饪/中国烹饪
五柳鱼	饮食/烹饪/中国烹饪/中国烹饪
五柳鲜鱼	饮食/烹饪/中国烹饪/中国烹饪
五柳黄花鱼	饮食/烹饪/中国烹饪/中国烹饪
五白糕	饮食/烹饪/中国烹饪/中国烹饪
五神饮	饮食/烹饪/中国烹饪/中国烹饪
五色鱼丁	饮食/烹饪/中国烹饪/中国烹饪
五花玻璃肉	饮食/烹饪/中国烹饪/中国烹饪
五香牛筋斗	饮食/烹饪/中国烹饪/中国烹饪
五香狗肉	饮食/烹饪/中国烹饪/中国烹饪
五香羊头肉	饮食/烹饪/中国烹饪/中国烹饪
五香肥鸭	饮食/烹饪/中国烹饪/中国烹饪
五香花生	饮食/烹饪/中国烹饪/中国烹饪
五香苦瓜	饮食/烹饪/中国烹饪/中国烹饪
五香豆腐干丝	饮食/烹饪/中国烹饪/中国烹饪
吴字坊	饮食/烹饪/中国烹饪/中国烹饪
外婆大品碗	饮食/烹饪/中国烹饪/中国烹饪
威宁荞酥	饮食/烹饪/中国烹饪/中国烹饪
文宇奶酪店	饮食/烹饪/中国烹饪/中国烹饪
文山鸡丁	饮食/烹饪/中国烹饪/中国烹饪
无锡排骨	饮食/烹饪/中国烹饪/中国烹饪
仙桃蒸三元	饮食/烹饪/中国烹饪/中国烹饪
削面	饮食/烹饪/中国烹饪/中国烹饪
厦门薄饼	饮食/烹饪/中国烹饪/中国烹饪
咸烧白	饮食/烹饪/中国烹饪/中国烹饪
咸菜鸭	饮食/烹饪/中国烹饪/中国烹饪
咸蛋节瓜鱼尾汤	饮食/烹饪/中国烹饪/中国烹饪
咸蛋蒸肉饼	饮食/烹饪/中国烹饪/中国烹饪
咸鱼鸡粒煮豆腐	饮食/烹饪/中国烹饪/中国烹饪
咸鸭蛋	饮食/烹饪/中国烹饪/中国烹饪
响铃肉圆	饮食/烹饪/中国烹饪/中国烹饪
夏暑清烦汤	饮食/烹饪/中国烹饪/中国烹饪
夏枯草菊花猪踭汤	饮食/烹饪/中国烹饪/中国烹饪
夏枯草银花饮	饮食/烹饪/中国烹饪/中国烹饪
夏枯草降脂茶	饮食/烹饪/中国烹饪/中国烹饪
夏草雌鸽补益汤	饮食/烹饪/中国烹饪/中国烹饪
孝感麻糖	饮食/烹饪/中国烹饪/中国烹饪
小吃	饮食/烹饪/中国烹饪/中国烹饪
小桃园煨汤	饮食/烹饪/中国烹饪/中国烹饪
小煎仔鸡	饮食/烹饪/中国烹饪/中国烹饪
小煎鸡	饮食/烹饪/中国烹饪/中国烹饪
小白菜苡米粥	饮食/烹饪/中国烹饪/中国烹饪
小窝头	饮食/烹饪/中国烹饪/中国烹饪
小米椒拌羊头	饮食/烹饪/中国烹饪/中国烹饪
小肠陈	饮食/烹饪/中国烹饪/中国烹饪
小葱烧财鱼	饮食/烹饪/中国烹饪/中国烹饪
小蒸包	饮食/烹饪/中国烹饪/中国烹饪
新兴牛肉丸	饮食/烹饪/中国烹饪/中国烹饪
新都桂花糕	饮食/烹饪/中国烹饪/中国烹饪
新鲜木瓜南北杏炖雪耳	饮食/烹饪/中国烹饪/中国烹饪
杏仁橄榄	饮食/烹饪/中国烹饪/中国烹饪
杏仁沙拉	饮食/烹饪/中国烹饪/中国烹饪
杏仁炖肉	饮食/烹饪/中国烹饪/中国烹饪
杏仁草莓奶昔	饮食/烹饪/中国烹饪/中国烹饪
杏仁银肺汤	饮食/烹饪/中国烹饪/中国烹饪
杏仁鱼鳃	饮食/烹饪/中国烹饪/中国烹饪
一卵孵双凤	饮食/烹饪/中国烹饪/中国烹饪
一品汽锅鸡	饮食/烹饪/中国烹饪/中国烹饪
一品薯包	饮食/烹饪/中国烹饪/中国烹饪
一品豆腐汤	饮食/烹饪/中国烹饪/中国烹饪
一品酥方	饮食/烹饪/中国烹饪/中国烹饪
一品鲍鱼	饮食/烹饪/中国烹饪/中国烹饪
一品鲳	饮食/烹饪/中国烹饪/中国烹饪
一品鲳鱼	饮食/烹饪/中国烹饪/中国烹饪
一菜两味鱼	饮食/烹饪/中国烹饪/中国烹饪
云尖爆牛柳	饮食/烹饪/中国烹饪/中国烹饪
云托八鲜	饮食/烹饪/中国烹饪/中国烹饪
云猪手	饮食/烹饪/中国烹饪/中国烹饪
云耳沙榄炖猪搌	饮食/烹饪/中国烹饪/中国烹饪
云耳西芹炒肉片	饮食/烹饪/中国烹饪/中国烹饪
云腿虾茸荚	饮食/烹饪/中国烹饪/中国烹饪
云苓黄精生蚝汤	饮食/烹饪/中国烹饪/中国烹饪
云长玉浆饺	饮食/烹饪/中国烹饪/中国烹饪
元宝牛蒡	饮食/烹饪/中国烹饪/中国烹饪
元气桑菊茶	饮食/烹饪/中国烹饪/中国烹饪
元蹄炖鸡	饮食/烹饪/中国烹饪/中国烹饪
养生汤	饮食/烹饪/中国烹饪/中国烹饪
养生肉桂奶茶	饮食/烹饪/中国烹饪/中国烹饪
养生菜根	饮食/烹饪/中国烹饪/中国烹饪
养生黑枣鲈鱼	饮食/烹饪/中国烹饪/中国烹饪
印度咖哩墨鱼饭	饮食/烹饪/中国烹饪/中国烹饪
原壳鲍鱼	饮食/烹饪/中国烹饪/中国烹饪
原盅炖北菇	饮食/烹饪/中国烹饪/中国烹饪
原笼玉簪	饮食/烹饪/中国烹饪/中国烹饪
原笼粉蒸	饮食/烹饪/中国烹饪/中国烹饪
又一顺	饮食/烹饪/中国烹饪/中国烹饪
圆白菜炒腊肉	饮食/烹饪/中国烹饪/中国烹饪
圆肉杞子炖鲍鱼	饮食/烹饪/中国烹饪/中国烹饪
圆肉花生排骨汤	饮食/烹饪/中国烹饪/中国烹饪
圆葱饭团	饮食/烹饪/中国烹饪/中国烹饪
夜香冬瓜盅	饮食/烹饪/中国烹饪/中国烹饪
姚记炒肝	饮食/烹饪/中国烹饪/中国烹饪
宜城大虾	饮食/烹饪/中国烹饪/中国烹饪
宜宾燃面	饮食/烹饪/中国烹饪/中国烹饪
应城扒肉	饮食/烹饪/中国烹饪/中国烹饪
延边长寿面	饮食/烹饪/中国烹饪/中国烹饪
意式杏仁脆饼	饮食/烹饪/中国烹饪/中国烹饪
扬州干丝	饮食/烹饪/中国烹饪/中国烹饪
月季花煨玉米笋	饮食/烹饪/中国烹饪/中国烹饪
月母子鸡	饮食/烹饪/中国烹饪/中国烹饪
杨村糕干	饮食/烹饪/中国烹饪/中国烹饪
杨梅虾球	饮食/烹饪/中国烹饪/中国烹饪
柚子封乌鸡	饮食/烹饪/中国烹饪/中国烹饪
柚子蜂蜜	饮食/烹饪/中国烹饪/中国烹饪
柚皮蒸排骨	饮食/烹饪/中国烹饪/中国烹饪
椰子马铃薯牛肉汤	饮食/烹饪/中国烹饪/中国烹饪
椰汁马豆糕	饮食/烹饪/中国烹饪/中国烹饪
中华药膳	饮食/烹饪/中国烹饪/中国烹饪
中华酱龙骨	饮食/烹饪/中国烹饪/中国烹饪
中式牛柳	饮食/烹饪/中国烹饪/中国烹饪
之江鲈莼羹	饮食/烹饪/中国烹饪/中国烹饪
仲景羊肉汤	饮食/烹饪/中国烹饪/中国烹饪
子姜鸭	饮食/烹饪/中国烹饪/中国烹饪
子萝卜汤	饮食/烹饪/中国烹饪/中国烹饪
子鱼勒丸子汤	饮食/烹饪/中国烹饪/中国烹饪
孜然羊肉	饮食/烹饪/中国烹饪/中国烹饪
张凉粉水饺店	饮食/烹饪/中国烹饪/中国烹饪
总汇沙拉	饮食/烹饪/中国烹饪/中国烹饪
抓炒鱼仁	饮食/烹饪/中国烹饪/中国烹饪
抓草鱼片	饮食/烹饪/中国烹饪/中国烹饪
折耳根炒肉丝	饮食/烹饪/中国烹饪/中国烹饪
折耳根炒腊肉	饮食/烹饪/中国烹饪/中国烹饪
支竹羊腩煲	饮食/烹饪/中国烹饪/中国烹饪
整鱼两吃	饮食/烹饪/中国烹饪/中国烹饪
斋鸭掌草菇煲	饮食/烹饪/中国烹饪/中国烹饪
斩鱼圆	饮食/烹饪/中国烹饪/中国烹饪
杂豆小麦粥	饮食/烹饪/中国烹饪/中国烹饪
枣仁龙眼粥	饮食/烹饪/中国烹饪/中国烹饪
枣糕	饮食/烹饪/中国烹饪/中国烹饪
枣莲炖雪哈	饮食/烹饪/中国烹饪/中国烹饪
柱侯酱凤爪	饮食/烹饪/中国烹饪/中国烹饪
梓潼片粉	饮食/烹饪/中国烹饪/中国烹饪
植物添银花	饮食/烹饪/中国烹饪/中国烹饪
榨广椒	饮食/烹饪/中国烹饪/中国烹饪
榨菜蒸大鳝	饮食/烹饪/中国烹饪/中国烹饪
榨菜豆芽肉丝汤	饮食/烹饪/中国烹饪/中国烹饪
榨菜钳鱼煲	饮食/烹饪/中国烹饪/中国烹饪
熬黄花鱼	饮食/烹饪/中国烹饪/八大菜系/八大菜系
腌苤蓝丝儿	饮食/烹饪/中国烹饪/八大菜系/八大菜系
腌鲜鳜鱼	饮食/烹饪/中国烹饪/八大菜系/八大菜系
八仙瑶池聚会	饮食/烹饪/中国烹饪/八大菜系/八大菜系
八仙过海闹罗汉	饮食/烹饪/中国烹饪/八大菜系/八大菜系
八代鱼	饮食/烹饪/中国烹饪/八大菜系/八大菜系
八宝原壳鲜贝	饮食/烹饪/中国烹饪/八大菜系/八大菜系
八宝梨罐	饮食/烹饪/中国烹饪/八大菜系/八大菜系
八宝榛子酱	饮食/烹饪/中国烹饪/八大菜系/八大菜系
八宝膳粥	饮食/烹饪/中国烹饪/八大菜系/八大菜系
八宝菠菜	饮食/烹饪/中国烹饪/八大菜系/八大菜系
八宝豆腐箱	饮食/烹饪/中国烹饪/八大菜系/八大菜系
冰糖炖甲鱼	饮食/烹饪/中国烹饪/八大菜系/八大菜系
冰糖甲鱼	饮食/烹饪/中国烹饪/八大菜系/八大菜系
冰糟肘子	饮食/烹饪/中国烹饪/八大菜系/八大菜系
冰花雪莲	饮食/烹饪/中国烹饪/八大菜系/八大菜系
扒三样儿	饮食/烹饪/中国烹饪/八大菜系/八大菜系
扒原壳鲍鱼	饮食/烹饪/中国烹饪/八大菜系/八大菜系
扒栗子白菜	饮食/烹饪/中国烹饪/八大菜系/八大菜系
扒海参	饮食/烹饪/中国烹饪/八大菜系/八大菜系
扒海羊	饮食/烹饪/中国烹饪/八大菜系/八大菜系
扒燕窝	饮食/烹饪/中国烹饪/八大菜系/八大菜系
扒牛肉条	饮食/烹饪/中国烹饪/八大菜系/八大菜系
扒肉	饮食/烹饪/中国烹饪/八大菜系/八大菜系
扒肘条	饮食/烹饪/中国烹饪/八大菜系/八大菜系
扒酿海参	饮食/烹饪/中国烹饪/八大菜系/八大菜系
扒面筋	饮食/烹饪/中国烹饪/八大菜系/八大菜系
扒鲍鱼双白	饮食/烹饪/中国烹饪/八大菜系/八大菜系
扒鲍鱼芦笋	饮食/烹饪/中国烹饪/八大菜系/八大菜系
扒鸡块儿	饮食/烹饪/中国烹饪/八大菜系/八大菜系
扒鸡腿儿	饮食/烹饪/中国烹饪/八大菜系/八大菜系
扒龙须鲍鱼	饮食/烹饪/中国烹饪/八大菜系/八大菜系
拌海蛰皮	饮食/烹饪/中国烹饪/八大菜系/八大菜系
拌海蜇	饮食/烹饪/中国烹饪/八大菜系/八大菜系
拌皮渣儿	饮食/烹饪/中国烹饪/八大菜系/八大菜系
拌稂子	饮食/烹饪/中国烹饪/八大菜系/八大菜系
拌肚丝	饮食/烹饪/中国烹饪/八大菜系/八大菜系
拌蟹肉	饮食/烹饪/中国烹饪/八大菜系/八大菜系
拌银耳	饮食/烹饪/中国烹饪/八大菜系/八大菜系
拌鸡丝	饮食/烹饪/中国烹饪/八大菜系/八大菜系
拔丝白薯球	饮食/烹饪/中国烹饪/八大菜系/八大菜系
拔丝空心小枣	饮食/烹饪/中国烹饪/八大菜系/八大菜系
拔丝苹果	饮食/烹饪/中国烹饪/八大菜系/八大菜系
板鸭	饮食/烹饪/中国烹饪/八大菜系/八大菜系
棒渣膳粥	饮食/烹饪/中国烹饪/八大菜系/八大菜系
爆三样儿	饮食/烹饪/中国烹饪/八大菜系/八大菜系
爆两样	饮食/烹饪/中国烹饪/八大菜系/八大菜系
爆墨鱼卷	饮食/烹饪/中国烹饪/八大菜系/八大菜系
爆墨鱼花	饮食/烹饪/中国烹饪/八大菜系/八大菜系
爆炒肉片	饮食/烹饪/中国烹饪/八大菜系/八大菜系
爆肚仁儿	饮食/烹饪/中国烹饪/八大菜系/八大菜系
爆腰花	饮食/烹饪/中国烹饪/八大菜系/八大菜系
爆金银鱼丁	饮食/烹饪/中国烹饪/八大菜系/八大菜系
白丸子	饮食/烹饪/中国烹饪/八大菜系/八大菜系
白扒通天鱼翅	饮食/烹饪/中国烹饪/八大菜系/八大菜系
白扒鱼翅	饮食/烹饪/中国烹饪/八大菜系/八大菜系
白梨凤脯	饮食/烹饪/中国烹饪/八大菜系/八大菜系
白汁全鱼	饮食/烹饪/中国烹饪/八大菜系/八大菜系
白汁酿鱼	饮食/烹饪/中国烹饪/八大菜系/八大菜系
白灼虾	饮食/烹饪/中国烹饪/八大菜系/八大菜系
白烧四宝	饮食/烹饪/中国烹饪/八大菜系/八大菜系
白玉鳝段	饮食/烹饪/中国烹饪/八大菜系/八大菜系
白肉	饮食/烹饪/中国烹饪/八大菜系/八大菜系
白肉丝儿	饮食/烹饪/中国烹饪/八大菜系/八大菜系
白肘子	饮食/烹饪/中国烹饪/八大菜系/八大菜系
白菜锅子	饮食/烹饪/中国烹饪/八大菜系/八大菜系
白银如意	饮食/烹饪/中国烹饪/八大菜系/八大菜系
百合炒螺片	饮食/烹饪/中国烹饪/八大菜系/八大菜系
百子冬瓜	饮食/烹饪/中国烹饪/八大菜系/八大菜系
百寿桃	饮食/烹饪/中国烹饪/八大菜系/八大菜系
百花大虾	饮食/烹饪/中国烹饪/八大菜系/八大菜系
百鸟还巢	饮食/烹饪/中国烹饪/八大菜系/八大菜系
荸荠一品锅	饮食/烹饪/中国烹饪/八大菜系/八大菜系
鲍王闹府	饮食/烹饪/中国烹饪/八大菜系/八大菜系
串串香	饮食/烹饪/中国烹饪/八大菜系/八大菜系
参婆千子	饮食/烹饪/中国烹饪/八大菜系/八大菜系
叉烧猪肉	饮食/烹饪/中国烹饪/八大菜系/八大菜系
川菜	饮食/烹饪/中国烹饪/八大菜系/八大菜系
川菜烹饪事典	饮食/烹饪/中国烹饪/八大菜系/八大菜系
彩椒山药	饮食/烹饪/中国烹饪/八大菜系/八大菜系
捶烩鸡片	饮食/烹饪/中国烹饪/八大菜系/八大菜系
插根儿	饮食/烹饪/中国烹饪/八大菜系/八大菜系
春笋腌笃鲜	饮食/烹饪/中国烹饪/八大菜系/八大菜系
春苗吐艳	饮食/烹饪/中国烹饪/八大菜系/八大菜系
朝天锅	饮食/烹饪/中国烹饪/八大菜系/八大菜系
漕溜鱼片	饮食/烹饪/中国烹饪/八大菜系/八大菜系
炒丝瓜	饮食/烹饪/中国烹饪/八大菜系/八大菜系
炒凤尾虾排	饮食/烹饪/中国烹饪/八大菜系/八大菜系
炒子蟹	饮食/烹饪/中国烹饪/八大菜系/八大菜系
炒山药泥	饮食/烹饪/中国烹饪/八大菜系/八大菜系
炒木樨肉	饮食/烹饪/中国烹饪/八大菜系/八大菜系
炒榛子酱	饮食/烹饪/中国烹饪/八大菜系/八大菜系
炒白虾	饮食/烹饪/中国烹饪/八大菜系/八大菜系
炒碧桃里脊	饮食/烹饪/中国烹饪/八大菜系/八大菜系
炒肉片儿	饮食/烹饪/中国烹饪/八大菜系/八大菜系
炒肝尖儿	饮食/烹饪/中国烹饪/八大菜系/八大菜系
炒芙蓉蟹黄	饮食/烹饪/中国烹饪/八大菜系/八大菜系
炒芡子米	饮食/烹饪/中国烹饪/八大菜系/八大菜系
炒荤素儿	饮食/烹饪/中国烹饪/八大菜系/八大菜系
炒虾丝	饮食/烹饪/中国烹饪/八大菜系/八大菜系
炒虾黄	饮食/烹饪/中国烹饪/八大菜系/八大菜系
炒蟹肉	饮食/烹饪/中国烹饪/八大菜系/八大菜系
炒豆腐脑	饮食/烹饪/中国烹饪/八大菜系/八大菜系
炒豌豆酱	饮食/烹饪/中国烹饪/八大菜系/八大菜系
炒蹄筋儿	饮食/烹饪/中国烹饪/八大菜系/八大菜系
炒银丝儿	饮食/烹饪/中国烹饪/八大菜系/八大菜系
炒银枝儿	饮食/烹饪/中国烹饪/八大菜系/八大菜系
炒面鱼	饮食/烹饪/中国烹饪/八大菜系/八大菜系
炒黄瓜酱	饮食/烹饪/中国烹饪/八大菜系/八大菜系
翅子汤	饮食/烹饪/中国烹饪/八大菜系/八大菜系
翠柳凤丝	饮食/烹饪/中国烹饪/八大菜系/八大菜系
翠玉豆糕	饮食/烹饪/中国烹饪/八大菜系/八大菜系
聪喝识	饮食/烹饪/中国烹饪/八大菜系/八大菜系
脆炸网油卷	饮食/烹饪/中国烹饪/八大菜系/八大菜系
脆皮乳鸽	饮食/烹饪/中国烹饪/八大菜系/八大菜系
脆皮烤乳猪	饮食/烹饪/中国烹饪/八大菜系/八大菜系
茶香牛肉	饮食/烹饪/中国烹饪/八大菜系/八大菜系
葱烧海参	饮食/烹饪/中国烹饪/八大菜系/八大菜系
葱爆牛柳	饮食/烹饪/中国烹饪/八大菜系/八大菜系
葱爆羊肉丁	饮食/烹饪/中国烹饪/八大菜系/八大菜系
葱花肉	饮食/烹饪/中国烹饪/八大菜系/八大菜系
醋椒黑鱼汤	饮食/烹饪/中国烹饪/八大菜系/八大菜系
醋烟肉片儿	饮食/烹饪/中国烹饪/八大菜系/八大菜系
醋酥鲫鱼	饮食/烹饪/中国烹饪/八大菜系/八大菜系
长CHANG春羹	饮食/烹饪/中国烹饪/八大菜系/八大菜系
陈醋全家福	饮食/烹饪/中国烹饪/八大菜系/八大菜系
丁香排骨	饮食/烹饪/中国烹饪/八大菜系/八大菜系
东阳千祥羊肉	饮食/烹饪/中国烹饪/八大菜系/八大菜系
东阳土鸡煲	饮食/烹饪/中国烹饪/八大菜系/八大菜系
冬笋里脊丝	饮食/烹饪/中国烹饪/八大菜系/八大菜系
大煮干丝	饮食/烹饪/中国烹饪/八大菜系/八大菜系
大蒜裙边	饮食/烹饪/中国烹饪/八大菜系/八大菜系
大蹄扒海参	饮食/烹饪/中国烹饪/八大菜系/八大菜系
带子上朝	饮食/烹饪/中国烹饪/八大菜系/八大菜系
带鱼	饮食/烹饪/中国烹饪/八大菜系/八大菜系
德州PA扒鸡	饮食/烹饪/中国烹饪/八大菜系/八大菜系
担担鸡	饮食/烹饪/中国烹饪/八大菜系/八大菜系
灯笼大虾	饮食/烹饪/中国烹饪/八大菜系/八大菜系
炖口蘑龙凤珠	饮食/烹饪/中国烹饪/八大菜系/八大菜系
炖吊子	饮食/烹饪/中国烹饪/八大菜系/八大菜系
蛋黄鱼片	饮食/烹饪/中国烹饪/八大菜系/八大菜系
豆沙凉糕	饮食/烹饪/中国烹饪/八大菜系/八大菜系
豆沙糕	饮食/烹饪/中国烹饪/八大菜系/八大菜系
豆腐丸子	饮食/烹饪/中国烹饪/八大菜系/八大菜系
豆鼓肉	饮食/烹饪/中国烹饪/八大菜系/八大菜系
豆鼓鲇鱼	饮食/烹饪/中国烹饪/八大菜系/八大菜系
仿膳饽饽	饮食/烹饪/中国烹饪/八大菜系/八大菜系
佛手广肚	饮食/烹饪/中国烹饪/八大菜系/八大菜系
佛手海参	饮食/烹饪/中国烹饪/八大菜系/八大菜系
佛手金卷	饮食/烹饪/中国烹饪/八大菜系/八大菜系
佛跳墙	饮食/烹饪/中国烹饪/八大菜系/八大菜系
凤凰出世	饮食/烹饪/中国烹饪/八大菜系/八大菜系
凤凰展翅	饮食/烹饪/中国烹饪/八大菜系/八大菜系
凤凰趴窝	饮食/烹饪/中国烹饪/八大菜系/八大菜系
凤凰鱼翅	饮食/烹饪/中国烹饪/八大菜系/八大菜系
凤凰鱼肚	饮食/烹饪/中国烹饪/八大菜系/八大菜系
凤尾群翅	饮食/烹饪/中国烹饪/八大菜系/八大菜系
凤尾金鱼	饮食/烹饪/中国烹饪/八大菜系/八大菜系
凤戏牡丹	饮食/烹饪/中国烹饪/八大菜系/八大菜系
凤眼秋波	饮食/烹饪/中国烹饪/八大菜系/八大菜系
凤穿金衣	饮食/烹饪/中国烹饪/八大菜系/八大菜系
凤脯珍珠	饮食/烹饪/中国烹饪/八大菜系/八大菜系
发菜黄花	饮食/烹饪/中国烹饪/八大菜系/八大菜系
奉化芋艿头	饮食/烹饪/中国烹饪/八大菜系/八大菜系
浮油鸡片	饮食/烹饪/中国烹饪/八大菜系/八大菜系
福山烧小鸡	饮食/烹饪/中国烹饪/八大菜系/八大菜系
翡翠玉扇	饮食/烹饪/中国烹饪/八大菜系/八大菜系
翡翠银耳	饮食/烹饪/中国烹饪/八大菜系/八大菜系
翡翠鱼丁	饮食/烹饪/中国烹饪/八大菜系/八大菜系
脯酥金鱼	饮食/烹饪/中国烹饪/八大菜系/八大菜系
芙蓉大虾	饮食/烹饪/中国烹饪/八大菜系/八大菜系
芙蓉山药卷	饮食/烹饪/中国烹饪/八大菜系/八大菜系
芙蓉海四宝	饮食/烹饪/中国烹饪/八大菜系/八大菜系
芙蓉燕菜	饮食/烹饪/中国烹饪/八大菜系/八大菜系
芙蓉管挺脊髓	饮食/烹饪/中国烹饪/八大菜系/八大菜系
芙蓉糕	饮食/烹饪/中国烹饪/八大菜系/八大菜系
芙蓉鱼角	饮食/烹饪/中国烹饪/八大菜系/八大菜系
芙蓉鱼骨	饮食/烹饪/中国烹饪/八大菜系/八大菜系
芙蓉鹿尾	饮食/烹饪/中国烹饪/八大菜系/八大菜系
共和凉菜卷	饮食/烹饪/中国烹饪/八大菜系/八大菜系
宫保兔肉	饮食/烹饪/中国烹饪/八大菜系/八大菜系
宫保鹌鹑	饮食/烹饪/中国烹饪/八大菜系/八大菜系
宫廷排翅	饮食/烹饪/中国烹饪/八大菜系/八大菜系
干炸丸子	饮食/烹饪/中国烹饪/八大菜系/八大菜系
干炸赤鳞鱼	饮食/烹饪/中国烹饪/八大菜系/八大菜系
干烧冬笋	饮食/烹饪/中国烹饪/八大菜系/八大菜系
干煎虾碌	饮食/烹饪/中国烹饪/八大菜系/八大菜系
干煸牛肉丝	饮食/烹饪/中国烹饪/八大菜系/八大菜系
干贝蒸肚尖	饮食/烹饪/中国烹饪/八大菜系/八大菜系
干贝酿冬瓜	饮食/烹饪/中国烹饪/八大菜系/八大菜系
广东油鸡淋酱	饮食/烹饪/中国烹饪/八大菜系/八大菜系
广式滷鸭翅	饮食/烹饪/中国烹饪/八大菜系/八大菜系
广式香炒面	饮食/烹饪/中国烹饪/八大菜系/八大菜系
怪味鲜鱿鱼	饮食/烹饪/中国烹饪/八大菜系/八大菜系
怪味鸡片	饮食/烹饪/中国烹饪/八大菜系/八大菜系
果珍莲藕	饮食/烹饪/中国烹饪/八大菜系/八大菜系
桂花干贝	饮食/烹饪/中国烹饪/八大菜系/八大菜系
桂花翅子	饮食/烹饪/中国烹饪/八大菜系/八大菜系
桂花鱼条	饮食/烹饪/中国烹饪/八大菜系/八大菜系
橄榄海味鲜	饮食/烹饪/中国烹饪/八大菜系/八大菜系
港式糯米饭 咕噜牛排	饮食/烹饪/中国烹饪/八大菜系/八大菜系
罐儿肉	饮食/烹饪/中国烹饪/八大菜系/八大菜系
罐儿野鸡	饮食/烹饪/中国烹饪/八大菜系/八大菜系
罐儿鹌鹑	饮食/烹饪/中国烹饪/八大菜系/八大菜系
羔烧羊肉	饮食/烹饪/中国烹饪/八大菜系/八大菜系
肝糕汤	饮食/烹饪/中国烹饪/八大菜系/八大菜系
莞爆牛百叶	饮食/烹饪/中国烹饪/八大菜系/八大菜系
蛤肉烩银耳	饮食/烹饪/中国烹饪/八大菜系/八大菜系
裹炸全鸭	饮食/烹饪/中国烹饪/八大菜系/八大菜系
赣菜	饮食/烹饪/中国烹饪/八大菜系/八大菜系
过桥鲈鱼	饮食/烹饪/中国烹饪/八大菜系/八大菜系
锅三夹火腿	饮食/烹饪/中国烹饪/八大菜系/八大菜系
锅塌菠菜	饮食/烹饪/中国烹饪/八大菜系/八大菜系
锅塌蒲菜	饮食/烹饪/中国烹饪/八大菜系/八大菜系
锅塌豆腐	饮食/烹饪/中国烹饪/八大菜系/八大菜系
锅塌鸡片	饮食/烹饪/中国烹饪/八大菜系/八大菜系
锅塌黄鱼	饮食/烹饪/中国烹饪/八大菜系/八大菜系
锅榻腰盒	饮食/烹饪/中国烹饪/八大菜系/八大菜系
锅烧海参	饮食/烹饪/中国烹饪/八大菜系/八大菜系
锅烧猪蹄儿	饮食/烹饪/中国烹饪/八大菜系/八大菜系
锅烧白菜	饮食/烹饪/中国烹饪/八大菜系/八大菜系
锅烧肘子	饮食/烹饪/中国烹饪/八大菜系/八大菜系
锅烧鲤鱼	饮食/烹饪/中国烹饪/八大菜系/八大菜系
锅烧鳗	饮食/烹饪/中国烹饪/八大菜系/八大菜系
锅烧鸡	饮食/烹饪/中国烹饪/八大菜系/八大菜系
锅烧鸭	饮食/烹饪/中国烹饪/八大菜系/八大菜系
锅煽鱼扇	饮食/烹饪/中国烹饪/八大菜系/八大菜系
锅熠银鱼	饮食/烹饪/中国烹饪/八大菜系/八大菜系
锅蹋韭菜	饮食/烹饪/中国烹饪/八大菜系/八大菜系
锅鳎银鱼	饮食/烹饪/中国烹饪/八大菜系/八大菜系
合菜盖被	饮食/烹饪/中国烹饪/八大菜系/八大菜系
含羞丸子	饮食/烹饪/中国烹饪/八大菜系/八大菜系
好丝百叶	饮食/烹饪/中国烹饪/八大菜系/八大菜系
徽菜	饮食/烹饪/中国烹饪/八大菜系/八大菜系
怀胎桂鱼	饮食/烹饪/中国烹饪/八大菜系/八大菜系
换心乌贼	饮食/烹饪/中国烹饪/八大菜系/八大菜系
核桃马来糕	饮食/烹饪/中国烹饪/八大菜系/八大菜系
洪江鸭	饮食/烹饪/中国烹饪/八大菜系/八大菜系
活钻鲤鱼	饮食/烹饪/中国烹饪/八大菜系/八大菜系
海参盆蒸	饮食/烹饪/中国烹饪/八大菜系/八大菜系
海参肘子	饮食/烹饪/中国烹饪/八大菜系/八大菜系
海底松银肺	饮食/烹饪/中国烹饪/八大菜系/八大菜系
海棠冬菇	饮食/烹饪/中国烹饪/八大菜系/八大菜系
海白米	饮食/烹饪/中国烹饪/八大菜系/八大菜系
海鲜小炒王	饮食/烹饪/中国烹饪/八大菜系/八大菜系
海鲜扒豆腐	饮食/烹饪/中国烹饪/八大菜系/八大菜系
海鲫鱼	饮食/烹饪/中国烹饪/八大菜系/八大菜系
淮扬菜	饮食/烹饪/中国烹饪/八大菜系/八大菜系
滑溜鹌鹑	饮食/烹饪/中国烹饪/八大菜系/八大菜系
火丁豌豆	饮食/烹饪/中国烹饪/八大菜系/八大菜系
火丝爆蛋	饮食/烹饪/中国烹饪/八大菜系/八大菜系
火炼金身	饮食/烹饪/中国烹饪/八大菜系/八大菜系
火烙金腿卷	饮食/烹饪/中国烹饪/八大菜系/八大菜系
火烧茨菰	饮食/烹饪/中国烹饪/八大菜系/八大菜系
火焰醉虾	饮食/烹饪/中国烹饪/八大菜系/八大菜系
火腿炒茄瓜	饮食/烹饪/中国烹饪/八大菜系/八大菜系
火腿炒蜗牛	饮食/烹饪/中国烹饪/八大菜系/八大菜系
火腿炖甲鱼	饮食/烹饪/中国烹饪/八大菜系/八大菜系
火蒙水蒸蛋	饮食/烹饪/中国烹饪/八大菜系/八大菜系
火踵神仙鸭	饮食/烹饪/中国烹饪/八大菜系/八大菜系
烀烂甲鱼	饮食/烹饪/中国烹饪/八大菜系/八大菜系
烀肉	饮食/烹饪/中国烹饪/八大菜系/八大菜系
烩乌龟蛋	饮食/烹饪/中国烹饪/八大菜系/八大菜系
烩南荠	饮食/烹饪/中国烹饪/八大菜系/八大菜系
烩散丹	饮食/烹饪/中国烹饪/八大菜系/八大菜系
烩海参	饮食/烹饪/中国烹饪/八大菜系/八大菜系
烩白杂碎	饮食/烹饪/中国烹饪/八大菜系/八大菜系
烩白菜	饮食/烹饪/中国烹饪/八大菜系/八大菜系
烩肥肠	饮食/烹饪/中国烹饪/八大菜系/八大菜系
烩脐肚	饮食/烹饪/中国烹饪/八大菜系/八大菜系
烩腰丁儿	饮食/烹饪/中国烹饪/八大菜系/八大菜系
烩节子	饮食/烹饪/中国烹饪/八大菜系/八大菜系
烩蟹肉	饮食/烹饪/中国烹饪/八大菜系/八大菜系
烩豌豆	饮食/烹饪/中国烹饪/八大菜系/八大菜系
烩酸燕儿	饮食/烹饪/中国烹饪/八大菜系/八大菜系
烩酸菜	饮食/烹饪/中国烹饪/八大菜系/八大菜系
烩酸蕾	饮食/烹饪/中国烹饪/八大菜系/八大菜系
烩银丝	饮食/烹饪/中国烹饪/八大菜系/八大菜系
烩银丝儿	饮食/烹饪/中国烹饪/八大菜系/八大菜系
烩银耳	饮食/烹饪/中国烹饪/八大菜系/八大菜系
烩鸭腰儿	饮食/烹饪/中国烹饪/八大菜系/八大菜系
猴头干贝	饮食/烹饪/中国烹饪/八大菜系/八大菜系
猴菇花枝饺	饮食/烹饪/中国烹饪/八大菜系/八大菜系
琥珀鸽蛋	饮食/烹饪/中国烹饪/八大菜系/八大菜系
红扒鱼唇	饮食/烹饪/中国烹饪/八大菜系/八大菜系
红扒鱼翅	饮食/烹饪/中国烹饪/八大菜系/八大菜系
红梅鱼肚	饮食/烹饪/中国烹饪/八大菜系/八大菜系
红烧大群翅	饮食/烹饪/中国烹饪/八大菜系/八大菜系
红烧大鲍翅	饮食/烹饪/中国烹饪/八大菜系/八大菜系
红烧果子狸	饮食/烹饪/中国烹饪/八大菜系/八大菜系
红烧狮子头煲	饮食/烹饪/中国烹饪/八大菜系/八大菜系
红烧猪腰	饮食/烹饪/中国烹饪/八大菜系/八大菜系
红烧蜗牛肉	饮食/烹饪/中国烹饪/八大菜系/八大菜系
红烧鱼唇	饮食/烹饪/中国烹饪/八大菜系/八大菜系
红烧鱼皮	饮食/烹饪/中国烹饪/八大菜系/八大菜系
红烧鱼骨	饮食/烹饪/中国烹饪/八大菜系/八大菜系
红烧鳝片	饮食/烹饪/中国烹饪/八大菜系/八大菜系
红烧鹿筋	饮食/烹饪/中国烹饪/八大菜系/八大菜系
红焖明皮	饮食/烹饪/中国烹饪/八大菜系/八大菜系
红焖海参	饮食/烹饪/中国烹饪/八大菜系/八大菜系
红煨牛肉	饮食/烹饪/中国烹饪/八大菜系/八大菜系
红糟杏鲍菇	饮食/烹饪/中国烹饪/八大菜系/八大菜系
红肘子	饮食/烹饪/中国烹饪/八大菜系/八大菜系
红豆膳粥	饮食/烹饪/中国烹饪/八大菜系/八大菜系
胡椒海参汤	饮食/烹饪/中国烹饪/八大菜系/八大菜系
胡芦桔翅	饮食/烹饪/中国烹饪/八大菜系/八大菜系
花开富贵	饮食/烹饪/中国烹饪/八大菜系/八大菜系
花式蒸饺	饮食/烹饪/中国烹饪/八大菜系/八大菜系
花枝玉米饼	饮食/烹饪/中国烹饪/八大菜系/八大菜系
花生酱糯米糍	饮食/烹饪/中国烹饪/八大菜系/八大菜系
花篮白菜	饮食/烹饪/中国烹饪/八大菜系/八大菜系
花雕鸡	饮食/烹饪/中国烹饪/八大菜系/八大菜系
荷包蟹肉	饮食/烹饪/中国烹饪/八大菜系/八大菜系
荷叶米粉鸡	饮食/烹饪/中国烹饪/八大菜系/八大菜系
荷叶肉	饮食/烹饪/中国烹饪/八大菜系/八大菜系
荷塘莲香	饮食/烹饪/中国烹饪/八大菜系/八大菜系
荷花酥	饮食/烹饪/中国烹饪/八大菜系/八大菜系
荷花金鱼虾	饮食/烹饪/中国烹饪/八大菜系/八大菜系
荷香蒸田鸡	饮食/烹饪/中国烹饪/八大菜系/八大菜系
葫芦大吉翅子	饮食/烹饪/中国烹饪/八大菜系/八大菜系
蚝油炒芥兰	饮食/烹饪/中国烹饪/八大菜系/八大菜系
蚝油牛肉丝	饮食/烹饪/中国烹饪/八大菜系/八大菜系
蚝油鲜竹卷	饮食/烹饪/中国烹饪/八大菜系/八大菜系
蚝皇凤爪	饮食/烹饪/中国烹饪/八大菜系/八大菜系
蝴蝶海参	饮食/烹饪/中国烹饪/八大菜系/八大菜系
话梅小萝卜	饮食/烹饪/中国烹饪/八大菜系/八大菜系
豢蝶大虾	饮食/烹饪/中国烹饪/八大菜系/八大菜系
九转大肠	饮食/烹饪/中国烹饪/八大菜系/八大菜系
劲霸孔府菜御笔刺身	饮食/烹饪/中国烹饪/八大菜系/八大菜系
叫化仔鸡	饮食/烹饪/中国烹饪/八大菜系/八大菜系
叫化童子鸡	饮食/烹饪/中国烹饪/八大菜系/八大菜系
吉祥干贝	饮食/烹饪/中国烹饪/八大菜系/八大菜系
姜汁扁豆	饮食/烹饪/中国烹饪/八大菜系/八大菜系
姜汁赤贝	饮食/烹饪/中国烹饪/八大菜系/八大菜系
家乡南肉	饮食/烹饪/中国烹饪/八大菜系/八大菜系
家常熬鱼	饮食/烹饪/中国烹饪/八大菜系/八大菜系
晶玉海棠	饮食/烹饪/中国烹饪/八大菜系/八大菜系
桔子大虾	饮食/烹饪/中国烹饪/八大菜系/八大菜系
桔子盏	饮食/烹饪/中国烹饪/八大菜系/八大菜系
椒盐肘子	饮食/烹饪/中国烹饪/八大菜系/八大菜系
江米酿鸭子	饮食/烹饪/中国烹饪/八大菜系/八大菜系
浆水鱼	饮食/烹饪/中国烹饪/八大菜系/八大菜系
焦馏里脊	饮食/烹饪/中国烹饪/八大菜系/八大菜系
煎瓤青红椒	饮食/烹饪/中国烹饪/八大菜系/八大菜系
煎蒸黄鱼	饮食/烹饪/中国烹饪/八大菜系/八大菜系
煎豆腐汆菠菜	饮食/烹饪/中国烹饪/八大菜系/八大菜系
煎转鲫鱼	饮食/烹饪/中国烹饪/八大菜系/八大菜系
煎酿茄子	饮食/烹饪/中国烹饪/八大菜系/八大菜系
煎雏肉	饮食/烹饪/中国烹饪/八大菜系/八大菜系
芥末鸭膀	饮食/烹饪/中国烹饪/八大菜系/八大菜系
芥汁软炸虾	饮食/烹饪/中国烹饪/八大菜系/八大菜系
荠菜鱼卷	饮食/烹饪/中国烹饪/八大菜系/八大菜系
菊花里脊	饮食/烹饪/中国烹饪/八大菜系/八大菜系
菊花锅子	饮食/烹饪/中国烹饪/八大菜系/八大菜系
菊花龙虎凤蛇羹	饮食/烹饪/中国烹饪/八大菜系/八大菜系
酒香椒盐肘子	饮食/烹饪/中国烹饪/八大菜系/八大菜系
酱汁鸭方	饮食/烹饪/中国烹饪/八大菜系/八大菜系
酱油风鹅肝酱拌面	饮食/烹饪/中国烹饪/八大菜系/八大菜系
酱泼肉	饮食/烹饪/中国烹饪/八大菜系/八大菜系
酱渍鳎目鱼	饮食/烹饪/中国烹饪/八大菜系/八大菜系
酱爆青蟹	饮食/烹饪/中国烹饪/八大菜系/八大菜系
酱瓜丝儿	饮食/烹饪/中国烹饪/八大菜系/八大菜系
酱羊肉	饮食/烹饪/中国烹饪/八大菜系/八大菜系
酱豆腐肉	饮食/烹饪/中国烹饪/八大菜系/八大菜系
酱鸡	饮食/烹饪/中国烹饪/八大菜系/八大菜系
金丝海蟹	饮食/烹饪/中国烹饪/八大菜系/八大菜系
金丝烧麦	饮食/烹饪/中国烹饪/八大菜系/八大菜系
金丝裹脆丸	饮食/烹饪/中国烹饪/八大菜系/八大菜系
金屋藏娇	饮食/烹饪/中国烹饪/八大菜系/八大菜系
金杯龙井虾	饮食/烹饪/中国烹饪/八大菜系/八大菜系
金毛狮子鱼	饮食/烹饪/中国烹饪/八大菜系/八大菜系
金狮绣球	饮食/烹饪/中国烹饪/八大菜系/八大菜系
金糕	饮食/烹饪/中国烹饪/八大菜系/八大菜系
金糕卷	饮食/烹饪/中国烹饪/八大菜系/八大菜系
金腿冬瓜夹	饮食/烹饪/中国烹饪/八大菜系/八大菜系
金腿千千结	饮食/烹饪/中国烹饪/八大菜系/八大菜系
金腿爆双脆	饮食/烹饪/中国烹饪/八大菜系/八大菜系
金腿鸡茸海参	饮食/烹饪/中国烹饪/八大菜系/八大菜系
金蟾拜月	饮食/烹饪/中国烹饪/八大菜系/八大菜系
金袍鲜贝	饮食/烹饪/中国烹饪/八大菜系/八大菜系
金针肉	饮食/烹饪/中国烹饪/八大菜系/八大菜系
金针菇银芽干贝酥	饮食/烹饪/中国烹饪/八大菜系/八大菜系
金针菇鲜蚵羹	饮食/烹饪/中国烹饪/八大菜系/八大菜系
金钱吐丝	饮食/烹饪/中国烹饪/八大菜系/八大菜系
金钱香菇	饮食/烹饪/中国烹饪/八大菜系/八大菜系
金钱鱼肚	饮食/烹饪/中国烹饪/八大菜系/八大菜系
金银蹄膀	饮食/烹饪/中国烹饪/八大菜系/八大菜系
金银鸽肉	饮食/烹饪/中国烹饪/八大菜系/八大菜系
金银鹿肉	饮食/烹饪/中国烹饪/八大菜系/八大菜系
金镶玉板	饮食/烹饪/中国烹饪/八大菜系/八大菜系
金鱼角	饮食/烹饪/中国烹饪/八大菜系/八大菜系
金鱼鸭掌	饮食/烹饪/中国烹饪/八大菜系/八大菜系
金鸡独立	饮食/烹饪/中国烹饪/八大菜系/八大菜系
韭菜炒海肠子	饮食/烹饪/中国烹饪/八大菜系/八大菜系
鸡丝汤面	饮食/烹饪/中国烹饪/八大菜系/八大菜系
鸡丝燕窝	饮食/烹饪/中国烹饪/八大菜系/八大菜系
鸡丝豆苗	饮食/烹饪/中国烹饪/八大菜系/八大菜系
鸡油香菇	饮食/烹饪/中国烹饪/八大菜系/八大菜系
鸡沾口蘑	饮食/烹饪/中国烹饪/八大菜系/八大菜系
鸡火二丁	饮食/烹饪/中国烹饪/八大菜系/八大菜系
鸡火百合	饮食/烹饪/中国烹饪/八大菜系/八大菜系
鸡粒玉米	饮食/烹饪/中国烹饪/八大菜系/八大菜系
侉炖羊肉	饮食/烹饪/中国烹饪/八大菜系/八大菜系
口蘑扒鱼脯	饮食/烹饪/中国烹饪/八大菜系/八大菜系
口蘑蕨菜汆豆腐	饮食/烹饪/中国烹饪/八大菜系/八大菜系
口蘑鹿肉	饮食/烹饪/中国烹饪/八大菜系/八大菜系
可乐焖鸡腿	饮食/烹饪/中国烹饪/八大菜系/八大菜系
咖喱菜花	饮食/烹饪/中国烹饪/八大菜系/八大菜系
咖喱饺	饮食/烹饪/中国烹饪/八大菜系/八大菜系
孔府一品锅	饮食/烹饪/中国烹饪/八大菜系/八大菜系
开水白菜	饮食/烹饪/中国烹饪/八大菜系/八大菜系
烤乳猪	饮食/烹饪/中国烹饪/八大菜系/八大菜系
烤小鸡	饮食/烹饪/中国烹饪/八大菜系/八大菜系
烤网油签	饮食/烹饪/中国烹饪/八大菜系/八大菜系
烤羊肉	饮食/烹饪/中国烹饪/八大菜系/八大菜系
烤肉	饮食/烹饪/中国烹饪/八大菜系/八大菜系
烤花揽桂鱼	饮食/烹饪/中国烹饪/八大菜系/八大菜系
烤花揽鳜鱼	饮食/烹饪/中国烹饪/八大菜系/八大菜系
烤鸭条	饮食/烹饪/中国烹饪/八大菜系/八大菜系
空心琉璃丸子	饮食/烹饪/中国烹饪/八大菜系/八大菜系
苦菜芽炒鸡丝	饮食/烹饪/中国烹饪/八大菜系/八大菜系
葵花麻鱼	饮食/烹饪/中国烹饪/八大菜系/八大菜系
两吃大虾	饮食/烹饪/中国烹饪/八大菜系/八大菜系
兰花春笋	饮食/烹饪/中国烹饪/八大菜系/八大菜系
兰花豆干	饮食/烹饪/中国烹饪/八大菜系/八大菜系
卤什件儿	饮食/烹饪/中国烹饪/八大菜系/八大菜系
卤子鹅	饮食/烹饪/中国烹饪/八大菜系/八大菜系
卤斑鸠	饮食/烹饪/中国烹饪/八大菜系/八大菜系
晾肉	饮食/烹饪/中国烹饪/八大菜系/八大菜系
栗子炒仔鸡	饮食/烹饪/中国烹饪/八大菜系/八大菜系
栗子烧双冬	饮食/烹饪/中国烹饪/八大菜系/八大菜系
栗子糕	饮食/烹饪/中国烹饪/八大菜系/八大菜系
栗子肉	饮食/烹饪/中国烹饪/八大菜系/八大菜系
栗子鸡	饮食/烹饪/中国烹饪/八大菜系/八大菜系
梁溪脆鳝，淮安软兜	饮食/烹饪/中国烹饪/八大菜系/八大菜系
炉猪	饮食/烹饪/中国烹饪/八大菜系/八大菜系
炉鸭	饮食/烹饪/中国烹饪/八大菜系/八大菜系
烂松菜滚豆腐	饮食/烹饪/中国烹饪/八大菜系/八大菜系
熘什件儿	饮食/烹饪/中国烹饪/八大菜系/八大菜系
熘白蘑	饮食/烹饪/中国烹饪/八大菜系/八大菜系
熘脊髓	饮食/烹饪/中国烹饪/八大菜系/八大菜系
熘腰花儿	饮食/烹饪/中国烹饪/八大菜系/八大菜系
熘蟹肉	饮食/烹饪/中国烹饪/八大菜系/八大菜系
熘蟹黄	饮食/烹饪/中国烹饪/八大菜系/八大菜系
熘鱼片儿	饮食/烹饪/中国烹饪/八大菜系/八大菜系
熘鱼肚	饮食/烹饪/中国烹饪/八大菜系/八大菜系
熘鱼脯	饮食/烹饪/中国烹饪/八大菜系/八大菜系
熘鲜蘑	饮食/烹饪/中国烹饪/八大菜系/八大菜系
琉璃珠玑	饮食/烹饪/中国烹饪/八大菜系/八大菜系
罗汉大虾	饮食/烹饪/中国烹饪/八大菜系/八大菜系
罗汉斋	饮食/烹饪/中国烹饪/八大菜系/八大菜系
老姜肉片汤	饮食/烹饪/中国烹饪/八大菜系/八大菜系
腊味合蒸	饮食/烹饪/中国烹饪/八大菜系/八大菜系
腊味煲仔饭	饮食/烹饪/中国烹饪/八大菜系/八大菜系
荔枝带鱼	饮食/烹饪/中国烹饪/八大菜系/八大菜系
荔枝鱿鱼	饮食/烹饪/中国烹饪/八大菜系/八大菜系
荔浦扣肉	饮食/烹饪/中国烹饪/八大菜系/八大菜系
莲子糕	饮食/烹饪/中国烹饪/八大菜系/八大菜系
莲子膳粥	饮食/烹饪/中国烹饪/八大菜系/八大菜系
莲花卷	饮食/烹饪/中国烹饪/八大菜系/八大菜系
萝卜桂鱼	饮食/烹饪/中国烹饪/八大菜系/八大菜系
萝卜鱼	饮食/烹饪/中国烹饪/八大菜系/八大菜系
落叶琵琶虾	饮食/烹饪/中国烹饪/八大菜系/八大菜系
螺炖肘花	饮食/烹饪/中国烹饪/八大菜系/八大菜系
辣味大头菜	饮食/烹饪/中国烹饪/八大菜系/八大菜系
辣子炒虾	饮食/烹饪/中国烹饪/八大菜系/八大菜系
辣爆鱼仁	饮食/烹饪/中国烹饪/八大菜系/八大菜系
辣豉香兔	饮食/烹饪/中国烹饪/八大菜系/八大菜系
馏鱼片	饮食/烹饪/中国烹饪/八大菜系/八大菜系
鲁肉饭便当	饮食/烹饪/中国烹饪/八大菜系/八大菜系
鲁菜百花大虾	饮食/烹饪/中国烹饪/八大菜系/八大菜系
鲁菜系	饮食/烹饪/中国烹饪/八大菜系/八大菜系
鲁菜麻粉肘子	饮食/烹饪/中国烹饪/八大菜系/八大菜系
明月映珊瑚	饮食/烹饪/中国烹饪/八大菜系/八大菜系
明珠豆腐	饮食/烹饪/中国烹饪/八大菜系/八大菜系
木樨菜	饮食/烹饪/中国烹饪/八大菜系/八大菜系
木瓜烩鱼肚	饮食/烹饪/中国烹饪/八大菜系/八大菜系
木耳豆鱼卷	饮食/烹饪/中国烹饪/八大菜系/八大菜系
梅竹山石	饮食/烹饪/中国烹饪/八大菜系/八大菜系
梅花香芋	饮食/烹饪/中国烹饪/八大菜系/八大菜系
母子相会	饮食/烹饪/中国烹饪/八大菜系/八大菜系
毛式烧肉	饮食/烹饪/中国烹饪/八大菜系/八大菜系
毛芋梗炖青豆	饮食/烹饪/中国烹饪/八大菜系/八大菜系
焖大虾	饮食/烹饪/中国烹饪/八大菜系/八大菜系
焖扁豆	饮食/烹饪/中国烹饪/八大菜系/八大菜系
焖白鳝	饮食/烹饪/中国烹饪/八大菜系/八大菜系
焖笋	饮食/烹饪/中国烹饪/八大菜系/八大菜系
焖肉段	饮食/烹饪/中国烹饪/八大菜系/八大菜系
焖鱼头	饮食/烹饪/中国烹饪/八大菜系/八大菜系
焖鸭掌儿	饮食/烹饪/中国烹饪/八大菜系/八大菜系
焖黄鳝	饮食/烹饪/中国烹饪/八大菜系/八大菜系
牡丹蝎托	饮食/烹饪/中国烹饪/八大菜系/八大菜系
猕猴桃肉丝	饮食/烹饪/中国烹饪/八大菜系/八大菜系
玛瑙银杏	饮食/烹饪/中国烹饪/八大菜系/八大菜系
米粉肉	饮食/烹饪/中国烹饪/八大菜系/八大菜系
美味虾卷	饮食/烹饪/中国烹饪/八大菜系/八大菜系
美宫山药	饮食/烹饪/中国烹饪/八大菜系/八大菜系
芒果密瓜烩蟹	饮食/烹饪/中国烹饪/八大菜系/八大菜系
蘑菇鸡	饮食/烹饪/中国烹饪/八大菜系/八大菜系
蜜三果	饮食/烹饪/中国烹饪/八大菜系/八大菜系
蜜汁地瓜	饮食/烹饪/中国烹饪/八大菜系/八大菜系
蜜汁山药	饮食/烹饪/中国烹饪/八大菜系/八大菜系
蜜汁梨球	饮食/烹饪/中国烹饪/八大菜系/八大菜系
蜜汁火腿	饮食/烹饪/中国烹饪/八大菜系/八大菜系
蜜汁肥桃	饮食/烹饪/中国烹饪/八大菜系/八大菜系
蜜汁薯丸	饮食/烹饪/中国烹饪/八大菜系/八大菜系
蜜汁金枣	饮食/烹饪/中国烹饪/八大菜系/八大菜系
蜜蜡肘子	饮食/烹饪/中国烹饪/八大菜系/八大菜系
闽菜	饮食/烹饪/中国烹饪/八大菜系/八大菜系
马牙肉	饮食/烹饪/中国烹饪/八大菜系/八大菜系
南排杂烩	饮食/烹饪/中国烹饪/八大菜系/八大菜系
南煎丸子	饮食/烹饪/中国烹饪/八大菜系/八大菜系
奶汤	饮食/烹饪/中国烹饪/八大菜系/八大菜系
奶汤元鱼	饮食/烹饪/中国烹饪/八大菜系/八大菜系
奶汤八宝布袋鸡	饮食/烹饪/中国烹饪/八大菜系/八大菜系
奶汤棱桃仁	饮食/烹饪/中国烹饪/八大菜系/八大菜系
奶汤蒲菜	饮食/烹饪/中国烹饪/八大菜系/八大菜系
奶汤鱼翅	饮食/烹饪/中国烹饪/八大菜系/八大菜系
奶汤鲜核桃仁	饮食/烹饪/中国烹饪/八大菜系/八大菜系
奶汤鸡脯	饮食/烹饪/中国烹饪/八大菜系/八大菜系
奶油扒菜芯	饮食/烹饪/中国烹饪/八大菜系/八大菜系
奶油桂鱼	饮食/烹饪/中国烹饪/八大菜系/八大菜系
奶油菠萝冻	饮食/烹饪/中国烹饪/八大菜系/八大菜系
奶油龙虾炖番茄	饮食/烹饪/中国烹饪/八大菜系/八大菜系
嫩炸牛排	饮食/烹饪/中国烹饪/八大菜系/八大菜系
宁式鳝糊	饮食/烹饪/中国烹饪/八大菜系/八大菜系
宁氏鳝丝	饮食/烹饪/中国烹饪/八大菜系/八大菜系
柠香心美	饮食/烹饪/中国烹饪/八大菜系/八大菜系
牛佛烘肘	饮食/烹饪/中国烹饪/八大菜系/八大菜系
糯米藕片	饮食/烹饪/中国烹饪/八大菜系/八大菜系
酿倭瓜	饮食/烹饪/中国烹饪/八大菜系/八大菜系
酿冬瓜	饮食/烹饪/中国烹饪/八大菜系/八大菜系
酿山药	饮食/烹饪/中国烹饪/八大菜系/八大菜系
酿银瓜	饮食/烹饪/中国烹饪/八大菜系/八大菜系
藕丝羹	饮食/烹饪/中国烹饪/八大菜系/八大菜系
品品醋黄河鲤鱼	饮食/烹饪/中国烹饪/八大菜系/八大菜系
啤酒炒活蟹	饮食/烹饪/中国烹饪/八大菜系/八大菜系
彭集红烧肘子	饮食/烹饪/中国烹饪/八大菜系/八大菜系
排南	饮食/烹饪/中国烹饪/八大菜系/八大菜系
排骨炖白菜	饮食/烹饪/中国烹饪/八大菜系/八大菜系
烹丁香	饮食/烹饪/中国烹饪/八大菜系/八大菜系
烹大肉	饮食/烹饪/中国烹饪/八大菜系/八大菜系
烹白肉	饮食/烹饪/中国烹饪/八大菜系/八大菜系
烹芽韭	饮食/烹饪/中国烹饪/八大菜系/八大菜系
琵琶大虾	饮食/烹饪/中国烹饪/八大菜系/八大菜系
全虾三做	饮食/烹饪/中国烹饪/八大菜系/八大菜系
千张牛肚邦	饮食/烹饪/中国烹饪/八大菜系/八大菜系
清拌粉皮儿	饮食/烹饪/中国烹饪/八大菜系/八大菜系
清拌腰丝儿	饮食/烹饪/中国烹饪/八大菜系/八大菜系
清汆黄河鲤鱼	饮食/烹饪/中国烹饪/八大菜系/八大菜系
清汤参鲍	饮食/烹饪/中国烹饪/八大菜系/八大菜系
清汤柳叶燕菜	饮食/烹饪/中国烹饪/八大菜系/八大菜系
清汤竹荪	饮食/烹饪/中国烹饪/八大菜系/八大菜系
清汤越鸡	饮食/烹饪/中国烹饪/八大菜系/八大菜系
清汤鱼圆	饮食/烹饪/中国烹饪/八大菜系/八大菜系
清汤鲍鱼	饮食/烹饪/中国烹饪/八大菜系/八大菜系
清汤鸡蒙冬菇	饮食/烹饪/中国烹饪/八大菜系/八大菜系
清炒鳝丝	饮食/烹饪/中国烹饪/八大菜系/八大菜系
清炖甲鱼	饮食/烹饪/中国烹饪/八大菜系/八大菜系
清炖蟹粉狮子头	饮食/烹饪/中国烹饪/八大菜系/八大菜系
清炖鱼翅	饮食/烹饪/中国烹饪/八大菜系/八大菜系
清炸大肠	饮食/烹饪/中国烹饪/八大菜系/八大菜系
清炸鹌鹑	饮食/烹饪/中国烹饪/八大菜系/八大菜系
清炸黄河刀鱼	饮食/烹饪/中国烹饪/八大菜系/八大菜系
清焖莲子	饮食/烹饪/中国烹饪/八大菜系/八大菜系
清羔羊肉	饮食/烹饪/中国烹饪/八大菜系/八大菜系
清蒸乳鸽	饮食/烹饪/中国烹饪/八大菜系/八大菜系
清蒸八宝猪	饮食/烹饪/中国烹饪/八大菜系/八大菜系
清蒸八宝甲鱼	饮食/烹饪/中国烹饪/八大菜系/八大菜系
清蒸哈什蚂	饮食/烹饪/中国烹饪/八大菜系/八大菜系
清蒸大蟹	饮食/烹饪/中国烹饪/八大菜系/八大菜系
清蒸火腿	饮食/烹饪/中国烹饪/八大菜系/八大菜系
清蒸翅子	饮食/烹饪/中国烹饪/八大菜系/八大菜系
清蒸鲥鱼	饮食/烹饪/中国烹饪/八大菜系/八大菜系
炝冬笋	饮食/烹饪/中国烹饪/八大菜系/八大菜系
炝玉龙片	饮食/烹饪/中国烹饪/八大菜系/八大菜系
炝竹笋	饮食/烹饪/中国烹饪/八大菜系/八大菜系
炝青蛤	饮食/烹饪/中国烹饪/八大菜系/八大菜系
炝黄瓜衣	饮食/烹饪/中国烹饪/八大菜系/八大菜系
秋实	饮食/烹饪/中国烹饪/八大菜系/八大菜系
秋菊傲霜	饮食/烹饪/中国烹饪/八大菜系/八大菜系
群虾戏荷	饮食/烹饪/中国烹饪/八大菜系/八大菜系
茄子晒炉肉	饮食/烹饪/中国烹饪/八大菜系/八大菜系
茄汁炆排骨	饮食/烹饪/中国烹饪/八大菜系/八大菜系
茄汁煨活鲍	饮食/烹饪/中国烹饪/八大菜系/八大菜系
茄汁石斑鱼	饮食/烹饪/中国烹饪/八大菜系/八大菜系
茄汤焗香鸡	饮食/烹饪/中国烹饪/八大菜系/八大菜系
青笋煨排骨	饮食/烹饪/中国烹饪/八大菜系/八大菜系
乳汁杏鲍菇	饮食/烹饪/中国烹饪/八大菜系/八大菜系
如意乌龙	饮食/烹饪/中国烹饪/八大菜系/八大菜系
如意卷	饮食/烹饪/中国烹饪/八大菜系/八大菜系
如意竹荪	饮食/烹饪/中国烹饪/八大菜系/八大菜系
日月生辉	饮食/烹饪/中国烹饪/八大菜系/八大菜系
肉丁辣酱	饮食/烹饪/中国烹饪/八大菜系/八大菜系
肉末炖海带	饮食/烹饪/中国烹饪/八大菜系/八大菜系
肉末烧饼	饮食/烹饪/中国烹饪/八大菜系/八大菜系
肉片炒干笋	饮食/烹饪/中国烹饪/八大菜系/八大菜系
肉米鱼唇	饮食/烹饪/中国烹饪/八大菜系/八大菜系
肉茸菠菜	饮食/烹饪/中国烹饪/八大菜系/八大菜系
茸汤广肚	饮食/烹饪/中国烹饪/八大菜系/八大菜系
茸鸡待哺	饮食/烹饪/中国烹饪/八大菜系/八大菜系
软炸里脊	饮食/烹饪/中国烹饪/八大菜系/八大菜系
软炸鲜贝	饮食/烹饪/中国烹饪/八大菜系/八大菜系
软炸鸡	饮食/烹饪/中国烹饪/八大菜系/八大菜系
软烧豆腐	饮食/烹饪/中国烹饪/八大菜系/八大菜系
三丝汤	饮食/烹饪/中国烹饪/八大菜系/八大菜系
三丝驼峰	饮食/烹饪/中国烹饪/八大菜系/八大菜系
三丝鱼翅	饮食/烹饪/中国烹饪/八大菜系/八大菜系
三套鸭	饮食/烹饪/中国烹饪/八大菜系/八大菜系
三彩大虾	饮食/烹饪/中国烹饪/八大菜系/八大菜系
三煲乳鸽	饮食/烹饪/中国烹饪/八大菜系/八大菜系
三美豆腐	饮食/烹饪/中国烹饪/八大菜系/八大菜系
三色明虾片	饮食/烹饪/中国烹饪/八大菜系/八大菜系
三色糕	饮食/烹饪/中国烹饪/八大菜系/八大菜系
三色蒸蛋	饮食/烹饪/中国烹饪/八大菜系/八大菜系
三色鸡鱼丸	饮食/烹饪/中国烹饪/八大菜系/八大菜系
三鲜丸子	饮食/烹饪/中国烹饪/八大菜系/八大菜系
三鲜木樨汤	饮食/烹饪/中国烹饪/八大菜系/八大菜系
三鲜瑶柱	饮食/烹饪/中国烹饪/八大菜系/八大菜系
三鲜蒸饺	饮食/烹饪/中国烹饪/八大菜系/八大菜系
三鲜酿面筋	饮食/烹饪/中国烹饪/八大菜系/八大菜系
三鲜鱼翅	饮食/烹饪/中国烹饪/八大菜系/八大菜系
三鲜鱼翅汤	饮食/烹饪/中国烹饪/八大菜系/八大菜系
三鲜鸭舌	饮食/烹饪/中国烹饪/八大菜系/八大菜系
什锦一品锅	饮食/烹饪/中国烹饪/八大菜系/八大菜系
什锦丁儿	饮食/烹饪/中国烹饪/八大菜系/八大菜系
什锦套肠儿	饮食/烹饪/中国烹饪/八大菜系/八大菜系
什锦汤圆	饮食/烹饪/中国烹饪/八大菜系/八大菜系
什锦苏盘儿	饮食/烹饪/中国烹饪/八大菜系/八大菜系
什锦葛仙米	饮食/烹饪/中国烹饪/八大菜系/八大菜系
什锦虾球	饮食/烹饪/中国烹饪/八大菜系/八大菜系
什锦蜂窝豆腐	饮食/烹饪/中国烹饪/八大菜系/八大菜系
什锦豆腐	饮食/烹饪/中国烹饪/八大菜系/八大菜系
什锦锅子	饮食/烹饪/中国烹饪/八大菜系/八大菜系
十二台菜	饮食/烹饪/中国烹饪/八大菜系/八大菜系
双冬辣鸡球	饮食/烹饪/中国烹饪/八大菜系/八大菜系
双参炖圆鱼	饮食/烹饪/中国烹饪/八大菜系/八大菜系
双味蹄筋	饮食/烹饪/中国烹饪/八大菜系/八大菜系
双烤肉	饮食/烹饪/中国烹饪/八大菜系/八大菜系
双色豆糕	饮食/烹饪/中国烹饪/八大菜系/八大菜系
双色马蹄糕	饮食/烹饪/中国烹饪/八大菜系/八大菜系
双虾丝瓜水晶粉	饮食/烹饪/中国烹饪/八大菜系/八大菜系
四喜丸子	饮食/烹饪/中国烹饪/八大菜系/八大菜系
四喜饺	饮食/烹饪/中国烹饪/八大菜系/八大菜系
四喜鱼卷	饮食/烹饪/中国烹饪/八大菜系/八大菜系
四喜鸭子	饮食/烹饪/中国烹饪/八大菜系/八大菜系
四川炒菜大全	饮食/烹饪/中国烹饪/八大菜系/八大菜系
四川菜味型手册	饮食/烹饪/中国烹饪/八大菜系/八大菜系
宋嫂鱼羹	饮食/烹饪/中国烹饪/八大菜系/八大菜系
山东大白菜	饮食/烹饪/中国烹饪/八大菜系/八大菜系
山东奶汤鸡脯	饮食/烹饪/中国烹饪/八大菜系/八大菜系
山东海参	饮食/烹饪/中国烹饪/八大菜系/八大菜系
山东烧鸡	饮食/烹饪/中国烹饪/八大菜系/八大菜系
山东糖煎藕	饮食/烹饪/中国烹饪/八大菜系/八大菜系
山东菜丸	饮食/烹饪/中国烹饪/八大菜系/八大菜系
山东菜椒盐肘子	饮食/烹饪/中国烹饪/八大菜系/八大菜系
山东菜肉丸	饮食/烹饪/中国烹饪/八大菜系/八大菜系
山鸡丁儿	饮食/烹饪/中国烹饪/八大菜系/八大菜系
手抓酱骨头	饮食/烹饪/中国烹饪/八大菜系/八大菜系
晒炉肉	饮食/烹饪/中国烹饪/八大菜系/八大菜系
松子香蘑	饮食/烹饪/中国烹饪/八大菜系/八大菜系
松树猴头	饮食/烹饪/中国烹饪/八大菜系/八大菜系
松肉	饮食/烹饪/中国烹饪/八大菜系/八大菜系
松花	饮食/烹饪/中国烹饪/八大菜系/八大菜系
松鼠厥鱼	饮食/烹饪/中国烹饪/八大菜系/八大菜系
松鼠桂鱼	饮食/烹饪/中国烹饪/八大菜系/八大菜系
松鼠鱼	饮食/烹饪/中国烹饪/八大菜系/八大菜系
氏丸子	饮食/烹饪/中国烹饪/八大菜系/八大菜系
水晶五彩虾球	饮食/烹饪/中国烹饪/八大菜系/八大菜系
水晶排骨	饮食/烹饪/中国烹饪/八大菜系/八大菜系
水晶明虾球	饮食/烹饪/中国烹饪/八大菜系/八大菜系
水晶肘子	饮食/烹饪/中国烹饪/八大菜系/八大菜系
水晶肴肉	饮食/烹饪/中国烹饪/八大菜系/八大菜系
水炒苜蓿虾仁	饮食/烹饪/中国烹饪/八大菜系/八大菜系
沙舟踏翠	饮食/烹饪/中国烹饪/八大菜系/八大菜系
沙锅散丹	饮食/烹饪/中国烹饪/八大菜系/八大菜系
沙锅炖吊子	饮食/烹饪/中国烹饪/八大菜系/八大菜系
沙锅牛尾	饮食/烹饪/中国烹饪/八大菜系/八大菜系
深山鱼头王	饮食/烹饪/中国烹饪/八大菜系/八大菜系
烧三鲜薇菜豆腐盒	饮食/烹饪/中国烹饪/八大菜系/八大菜系
烧五丝	饮食/烹饪/中国烹饪/八大菜系/八大菜系
烧子鹅	饮食/烹饪/中国烹饪/八大菜系/八大菜系
烧安南子	饮食/烹饪/中国烹饪/八大菜系/八大菜系
烧宝盖GAI儿	饮食/烹饪/中国烹饪/八大菜系/八大菜系
烧椒鹌鹑皮蛋	饮食/烹饪/中国烹饪/八大菜系/八大菜系
烧槟子	饮食/烹饪/中国烹饪/八大菜系/八大菜系
烧瓤菜花	饮食/烹饪/中国烹饪/八大菜系/八大菜系
烧百合	饮食/烹饪/中国烹饪/八大菜系/八大菜系
烧紫盖GAI儿	饮食/烹饪/中国烹饪/八大菜系/八大菜系
烧罗汉面筋	饮食/烹饪/中国烹饪/八大菜系/八大菜系
烧羊肉	饮食/烹饪/中国烹饪/八大菜系/八大菜系
烧肉	饮食/烹饪/中国烹饪/八大菜系/八大菜系
烧肝尖儿	饮食/烹饪/中国烹饪/八大菜系/八大菜系
烧肥肠儿	饮食/烹饪/中国烹饪/八大菜系/八大菜系
烧肺	饮食/烹饪/中国烹饪/八大菜系/八大菜系
烧脂盖	饮食/烹饪/中国烹饪/八大菜系/八大菜系
烧花鸭	饮食/烹饪/中国烹饪/八大菜系/八大菜系
烧萝卜	饮食/烹饪/中国烹饪/八大菜系/八大菜系
烧连帖	饮食/烹饪/中国烹饪/八大菜系/八大菜系
烧酿海参	饮食/烹饪/中国烹饪/八大菜系/八大菜系
烧雏鸡	饮食/烹饪/中国烹饪/八大菜系/八大菜系
烧鱼头	饮食/烹饪/中国烹饪/八大菜系/八大菜系
烧鸳鸯	饮食/烹饪/中国烹饪/八大菜系/八大菜系
珊瑚金钩	饮食/烹饪/中国烹饪/八大菜系/八大菜系
素炝春不老	饮食/烹饪/中国烹饪/八大菜系/八大菜系
蒜子牛蹄黄	饮食/烹饪/中国烹饪/八大菜系/八大菜系
蒜子鱼皮	饮食/烹饪/中国烹饪/八大菜系/八大菜系
蒜泥鸡蛋	饮食/烹饪/中国烹饪/八大菜系/八大菜系
蒜爆肉	饮食/烹饪/中国烹饪/八大菜系/八大菜系
蒜苗火鸡排	饮食/烹饪/中国烹饪/八大菜系/八大菜系
蓑衣虾球	饮食/烹饪/中国烹饪/八大菜系/八大菜系
酥卷佛手	饮食/烹饪/中国烹饪/八大菜系/八大菜系
酥炸春花肉	饮食/烹饪/中国烹饪/八大菜系/八大菜系
酥烂蹄筋	饮食/烹饪/中国烹饪/八大菜系/八大菜系
酥皮鸭	饮食/烹饪/中国烹饪/八大菜系/八大菜系
酥锅	饮食/烹饪/中国烹饪/八大菜系/八大菜系
酥页层层	饮食/烹饪/中国烹饪/八大菜系/八大菜系
酸黄菜	饮食/烹饪/中国烹饪/八大菜系/八大菜系
随滑飞龙	饮食/烹饪/中国烹饪/八大菜系/八大菜系
兔脯	饮食/烹饪/中国烹饪/八大菜系/八大菜系
土豆焖蛋	饮食/烹饪/中国烹饪/八大菜系/八大菜系
土鸡蛋面	饮食/烹饪/中国烹饪/八大菜系/八大菜系
坛子肉	饮食/烹饪/中国烹饪/八大菜系/八大菜系
太极发财燕	饮食/烹饪/中国烹饪/八大菜系/八大菜系
太极组合盘	饮食/烹饪/中国烹饪/八大菜系/八大菜系
太爷鸡	饮食/烹饪/中国烹饪/八大菜系/八大菜系
拖煎黄鱼	饮食/烹饪/中国烹饪/八大菜系/八大菜系
桃仁鸡丁	饮食/烹饪/中国烹饪/八大菜系/八大菜系
棠花吐蕊	饮食/烹饪/中国烹饪/八大菜系/八大菜系
檀扇鸭掌	饮食/烹饪/中国烹饪/八大菜系/八大菜系
氽三样儿	饮食/烹饪/中国烹饪/八大菜系/八大菜系
氽丸子	饮食/烹饪/中国烹饪/八大菜系/八大菜系
氽发菜三丝	饮食/烹饪/中国烹饪/八大菜系/八大菜系
氽大甲	饮食/烹饪/中国烹饪/八大菜系/八大菜系
氽毛豆	饮食/烹饪/中国烹饪/八大菜系/八大菜系
氽珍珠螺片	饮食/烹饪/中国烹饪/八大菜系/八大菜系
氽肥肠儿	饮食/烹饪/中国烹饪/八大菜系/八大菜系
氽节子	饮食/烹饪/中国烹饪/八大菜系/八大菜系
氽虾蘑海	饮食/烹饪/中国烹饪/八大菜系/八大菜系
氽西施舌	饮食/烹饪/中国烹饪/八大菜系/八大菜系
氽鲤鱼	饮食/烹饪/中国烹饪/八大菜系/八大菜系
汤圆锅子	饮食/烹饪/中国烹饪/八大菜系/八大菜系
汤大玉	饮食/烹饪/中国烹饪/八大菜系/八大菜系
汤溪野菜包	饮食/烹饪/中国烹饪/八大菜系/八大菜系
汤爆双脆	饮食/烹饪/中国烹饪/八大菜系/八大菜系
汤羊	饮食/烹饪/中国烹饪/八大菜系/八大菜系
泰安三美豆腐	饮食/烹饪/中国烹饪/八大菜系/八大菜系
泰山豆腐花	饮食/烹饪/中国烹饪/八大菜系/八大菜系
泰山赤鳞鱼	饮食/烹饪/中国烹饪/八大菜系/八大菜系
甜乐豆腐	饮食/烹饪/中国烹饪/八大菜系/八大菜系
筒子鸡	饮食/烹饪/中国烹饪/八大菜系/八大菜系
糖炒虾瓣	饮食/烹饪/中国烹饪/八大菜系/八大菜系
糖焖莲子	饮食/烹饪/中国烹饪/八大菜系/八大菜系
糖熘饹儿	饮食/烹饪/中国烹饪/八大菜系/八大菜系
糖熘鲤鱼	饮食/烹饪/中国烹饪/八大菜系/八大菜系
糖醋棒子鱼	饮食/烹饪/中国烹饪/八大菜系/八大菜系
糖醋海肠花	饮食/烹饪/中国烹饪/八大菜系/八大菜系
糖醋烧黄河鲤鱼	饮食/烹饪/中国烹饪/八大菜系/八大菜系
糖醋荷藕	饮食/烹饪/中国烹饪/八大菜系/八大菜系
糖醋鱼卷	饮食/烹饪/中国烹饪/八大菜系/八大菜系
糖醋鱼块	饮食/烹饪/中国烹饪/八大菜系/八大菜系
糖醋鱼条	饮食/烹饪/中国烹饪/八大菜系/八大菜系
糖醋黄河鲤鱼	饮食/烹饪/中国烹饪/八大菜系/八大菜系
苔菜小方烤	饮食/烹饪/中国烹饪/八大菜系/八大菜系
铁板蚝油栗子鸡	饮食/烹饪/中国烹饪/八大菜系/八大菜系
铁素四色球	饮食/烹饪/中国烹饪/八大菜系/八大菜系
鳎目鱼	饮食/烹饪/中国烹饪/八大菜系/八大菜系
万年长青	饮食/烹饪/中国烹饪/八大菜系/八大菜系
乌龙赛熊掌	饮食/烹饪/中国烹饪/八大菜系/八大菜系
五丝洋粉	饮食/烹饪/中国烹饪/八大菜系/八大菜系
五丝菜卷	饮食/烹饪/中国烹饪/八大菜系/八大菜系
五味双鲜	饮食/烹饪/中国烹饪/八大菜系/八大菜系
五味煎蟹	饮食/烹饪/中国烹饪/八大菜系/八大菜系
五彩墨鱼丝	饮食/烹饪/中国烹饪/八大菜系/八大菜系
五彩炒蛇丝	饮食/烹饪/中国烹饪/八大菜系/八大菜系
五彩疙瘩丝	饮食/烹饪/中国烹饪/八大菜系/八大菜系
五彩鲜贝	饮食/烹饪/中国烹饪/八大菜系/八大菜系
五通桥月糕	饮食/烹饪/中国烹饪/八大菜系/八大菜系
五香牛筋斗	饮食/烹饪/中国烹饪/八大菜系/八大菜系
五香羊肉	饮食/烹饪/中国烹饪/八大菜系/八大菜系
卧龙戏珠	饮食/烹饪/中国烹饪/八大菜系/八大菜系
嗡山药	饮食/烹饪/中国烹饪/八大菜系/八大菜系
无锡排骨	饮食/烹饪/中国烹饪/八大菜系/八大菜系
网油棒榻	饮食/烹饪/中国烹饪/八大菜系/八大菜系
网油鱼卷	饮食/烹饪/中国烹饪/八大菜系/八大菜系
芜爆山鸡	饮食/烹饪/中国烹饪/八大菜系/八大菜系
芜爆鲜贝	饮食/烹饪/中国烹饪/八大菜系/八大菜系
莴笋	饮食/烹饪/中国烹饪/八大菜系/八大菜系
雾熘桂鱼	饮食/烹饪/中国烹饪/八大菜系/八大菜系
仙鹤鲍鱼	饮食/烹饪/中国烹饪/八大菜系/八大菜系
咸肉丝儿	饮食/烹饪/中国烹饪/八大菜系/八大菜系
咸菜大汤黄鱼	饮食/烹饪/中国烹饪/八大菜系/八大菜系
咸鱼芋艿	饮食/烹饪/中国烹饪/八大菜系/八大菜系
咸鱼锅子	饮食/烹饪/中国烹饪/八大菜系/八大菜系
喜鹊登枝	饮食/烹饪/中国烹饪/八大菜系/八大菜系
小炒螃蟹	饮食/烹饪/中国烹饪/八大菜系/八大菜系
小煎吉米	饮食/烹饪/中国烹饪/八大菜系/八大菜系
小肚儿	饮食/烹饪/中国烹饪/八大菜系/八大菜系
小豆糕	饮食/烹饪/中国烹饪/八大菜系/八大菜系
杏仁儿酪	饮食/烹饪/中国烹饪/八大菜系/八大菜系
杏仁豆腐	饮食/烹饪/中国烹饪/八大菜系/八大菜系
湘系（湖南菜）	饮食/烹饪/中国烹饪/八大菜系/八大菜系
湘菜	饮食/烹饪/中国烹饪/八大菜系/八大菜系
熊猫品竹	饮食/烹饪/中国烹饪/八大菜系/八大菜系
熊猫蟹肉	饮食/烹饪/中国烹饪/八大菜系/八大菜系
熏斑鸠	饮食/烹饪/中国烹饪/八大菜系/八大菜系
熏肘子	饮食/烹饪/中国烹饪/八大菜系/八大菜系
熏鸡白肚儿	饮食/烹饪/中国烹饪/八大菜系/八大菜系
祥云凤展翅	饮食/烹饪/中国烹饪/八大菜系/八大菜系
祥龙献宝	饮食/烹饪/中国烹饪/八大菜系/八大菜系
秀珍菇炒虾仁	饮食/烹饪/中国烹饪/八大菜系/八大菜系
箱包豆腐	饮食/烹饪/中国烹饪/八大菜系/八大菜系
绣球全鱼	饮食/烹饪/中国烹饪/八大菜系/八大菜系
绣球干贝	饮食/烹饪/中国烹饪/八大菜系/八大菜系
绣球蛋糕	饮食/烹饪/中国烹饪/八大菜系/八大菜系
虾子菜花	饮食/烹饪/中国烹饪/八大菜系/八大菜系
虾油鸡	饮食/烹饪/中国烹饪/八大菜系/八大菜系
虾爆鳝面	饮食/烹饪/中国烹饪/八大菜系/八大菜系
蟹粉鱼翅	饮食/烹饪/中国烹饪/八大菜系/八大菜系
蟹肉羹	饮食/烹饪/中国烹饪/八大菜系/八大菜系
蟹肉金勾翅	饮食/烹饪/中国烹饪/八大菜系/八大菜系
蟹黄海参	饮食/烹饪/中国烹饪/八大菜系/八大菜系
蟹黄蹄筋	饮食/烹饪/中国烹饪/八大菜系/八大菜系
蟹黄鱼翅	饮食/烹饪/中国烹饪/八大菜系/八大菜系
西兰大龙虾	饮食/烹饪/中国烹饪/八大菜系/八大菜系
西湖莼菜汤	饮食/烹饪/中国烹饪/八大菜系/八大菜系
西湖醋鱼	饮食/烹饪/中国烹饪/八大菜系/八大菜系
西瓜鸡	饮食/烹饪/中国烹饪/八大菜系/八大菜系
西芹百合虾仁	饮食/烹饪/中国烹饪/八大菜系/八大菜系
象眼鸽蛋	饮食/烹饪/中国烹饪/八大菜系/八大菜系
雪丽蟹斗	饮食/烹饪/中国烹饪/八大菜系/八大菜系
雪月羊肉	饮食/烹饪/中国烹饪/八大菜系/八大菜系
雪梨肘棒	饮食/烹饪/中国烹饪/八大菜系/八大菜系
雪菜大汤黄鱼	饮食/烹饪/中国烹饪/八大菜系/八大菜系
雪里藏珍	饮食/烹饪/中国烹饪/八大菜系/八大菜系
香卤猪肘	饮食/烹饪/中国烹饪/八大菜系/八大菜系
香榧焖鸡脯	饮食/烹饪/中国烹饪/八大菜系/八大菜系
香炸响铃	饮食/烹饪/中国烹饪/八大菜系/八大菜系
香爆螺盏	饮食/烹饪/中国烹饪/八大菜系/八大菜系
香肠儿	饮食/烹饪/中国烹饪/八大菜系/八大菜系
香葱烘蛋	饮食/烹饪/中国烹饪/八大菜系/八大菜系
香蒜无黄蛋	饮食/烹饪/中国烹饪/八大菜系/八大菜系
香蕉鲜虾卷	饮食/烹饪/中国烹饪/八大菜系/八大菜系
香酥牛肉	饮食/烹饪/中国烹饪/八大菜系/八大菜系
香酥猴头菇	饮食/烹饪/中国烹饪/八大菜系/八大菜系
香酥萝卜丸子	饮食/烹饪/中国烹饪/八大菜系/八大菜系
香酥鸡	饮食/烹饪/中国烹饪/八大菜系/八大菜系
香露炖花菇	饮食/烹饪/中国烹饪/八大菜系/八大菜系
香露苹果	饮食/烹饪/中国烹饪/八大菜系/八大菜系
香麻虾球	饮食/烹饪/中国烹饪/八大菜系/八大菜系
鲜味大虾	饮食/烹饪/中国烹饪/八大菜系/八大菜系
鲜贝冬瓜球	饮食/烹饪/中国烹饪/八大菜系/八大菜系
鲜香炒全蟹	饮食/烹饪/中国烹饪/八大菜系/八大菜系
鲞扣鸡	饮食/烹饪/中国烹饪/八大菜系/八大菜系
一卵孵双凤	饮食/烹饪/中国烹饪/八大菜系/八大菜系
一品官燕	饮食/烹饪/中国烹饪/八大菜系/八大菜系
一品寿桃	饮食/烹饪/中国烹饪/八大菜系/八大菜系
一品清汤燕窝	饮食/烹饪/中国烹饪/八大菜系/八大菜系
一品肉	饮食/烹饪/中国烹饪/八大菜系/八大菜系
一品酱羊肉	饮食/烹饪/中国烹饪/八大菜系/八大菜系
云河段霄	饮食/烹饪/中国烹饪/八大菜系/八大菜系
云片猴头	饮食/烹饪/中国烹饪/八大菜系/八大菜系
云片鸽蛋	饮食/烹饪/中国烹饪/八大菜系/八大菜系
云片鹿角菜	饮食/烹饪/中国烹饪/八大菜系/八大菜系
元宝酥	饮食/烹饪/中国烹饪/八大菜系/八大菜系
御扇豆黄	饮食/烹饪/中国烹饪/八大菜系/八大菜系
御龙火锅	饮食/烹饪/中国烹饪/八大菜系/八大菜系
扬州酱菜	饮食/烹饪/中国烹饪/八大菜系/八大菜系
杨梅虾球	饮食/烹饪/中国烹饪/八大菜系/八大菜系
椰蓉鲜贝串	饮食/烹饪/中国烹饪/八大菜系/八大菜系
樱桃肉	饮食/烹饪/中国烹饪/八大菜系/八大菜系
油攒大虾	饮食/烹饪/中国烹饪/八大菜系/八大菜系
油泡象鼻蚌	饮食/烹饪/中国烹饪/八大菜系/八大菜系
油泼肉	饮食/烹饪/中国烹饪/八大菜系/八大菜系
油泼青鱼	饮食/烹饪/中国烹饪/八大菜系/八大菜系
油泼鸡	饮食/烹饪/中国烹饪/八大菜系/八大菜系
油炸肺	饮食/烹饪/中国烹饪/八大菜系/八大菜系
油焖凤尾鱼	饮食/烹饪/中国烹饪/八大菜系/八大菜系
油焖基围虾	饮食/烹饪/中国烹饪/八大菜系/八大菜系
油焖春笋	饮食/烹饪/中国烹饪/八大菜系/八大菜系
油焖鲜蘑	饮食/烹饪/中国烹饪/八大菜系/八大菜系
油爆双脆	饮食/烹饪/中国烹饪/八大菜系/八大菜系
油爆双鲜	饮食/烹饪/中国烹饪/八大菜系/八大菜系
油爆鱼芹	饮食/烹饪/中国烹饪/八大菜系/八大菜系
油爆鲜贝	饮食/烹饪/中国烹饪/八大菜系/八大菜系
油鹏自远方来	饮食/烹饪/中国烹饪/八大菜系/八大菜系
烟三鲜儿	饮食/烹饪/中国烹饪/八大菜系/八大菜系
烟刀鱼	饮食/烹饪/中国烹饪/八大菜系/八大菜系
烟鸭掌儿	饮食/烹饪/中国烹饪/八大菜系/八大菜系
烟鸽子蛋	饮食/烹饪/中国烹饪/八大菜系/八大菜系
燕尾桃花	饮食/烹饪/中国烹饪/八大菜系/八大菜系
燕影金蔬	饮食/烹饪/中国烹饪/八大菜系/八大菜系
燕窝四字	饮食/烹饪/中国烹饪/八大菜系/八大菜系
玉兔白菜	饮食/烹饪/中国烹饪/八大菜系/八大菜系
玉兰片	饮食/烹饪/中国烹饪/八大菜系/八大菜系
玉掌献寿	饮食/烹饪/中国烹饪/八大菜系/八大菜系
玉板翠带	饮食/烹饪/中国烹饪/八大菜系/八大菜系
玉盏龙眼	饮食/烹饪/中国烹饪/八大菜系/八大菜系
玉米色拉	饮食/烹饪/中国烹饪/八大菜系/八大菜系
盐水肘花儿	饮食/烹饪/中国烹饪/八大菜系/八大菜系
禹城扒鸡	饮食/烹饪/中国烹饪/八大菜系/八大菜系
粤系（广东菜)	饮食/烹饪/中国烹饪/八大菜系/八大菜系
粤菜	饮食/烹饪/中国烹饪/八大菜系/八大菜系
腰果虾仁	饮食/烹饪/中国烹饪/八大菜系/八大菜系
芫爆墨鱼	饮食/烹饪/中国烹饪/八大菜系/八大菜系
芫爆肚丝	饮食/烹饪/中国烹饪/八大菜系/八大菜系
芫爆腰条	饮食/烹饪/中国烹饪/八大菜系/八大菜系
芫爆鱿鱼卷	饮食/烹饪/中国烹饪/八大菜系/八大菜系
芸豆金鱼	饮食/烹饪/中国烹饪/八大菜系/八大菜系
薏米膳继	饮食/烹饪/中国烹饪/八大菜系/八大菜系
迎宾花篮	饮食/烹饪/中国烹饪/八大菜系/八大菜系
银珠鲍鱼	饮食/烹饪/中国烹饪/八大菜系/八大菜系
银耳烩菜心	饮食/烹饪/中国烹饪/八大菜系/八大菜系
鱼包三经	饮食/烹饪/中国烹饪/八大菜系/八大菜系
鱼扇海参	饮食/烹饪/中国烹饪/八大菜系/八大菜系
鱼脯丸子	饮食/烹饪/中国烹饪/八大菜系/八大菜系
鱼香肉丝	饮食/烹饪/中国烹饪/八大菜系/八大菜系
丈母鱼丸汤	饮食/烹饪/中国烹饪/八大菜系/八大菜系
中华菜系	饮食/烹饪/中国烹饪/八大菜系/八大菜系
中国鲁菜文化	饮食/烹饪/中国烹饪/八大菜系/八大菜系
中江挂面	饮食/烹饪/中国烹饪/八大菜系/八大菜系
抓炒大虾	饮食/烹饪/中国烹饪/八大菜系/八大菜系
抓炒对虾	饮食/烹饪/中国烹饪/八大菜系/八大菜系
抓炒里脊	饮食/烹饪/中国烹饪/八大菜系/八大菜系
抓炒鱼仁	饮食/烹饪/中国烹饪/八大菜系/八大菜系
抓炒鱼片	饮食/烹饪/中国烹饪/八大菜系/八大菜系
抓炒鲤鱼	饮食/烹饪/中国烹饪/八大菜系/八大菜系
整鱼两吃	饮食/烹饪/中国烹饪/八大菜系/八大菜系
斋鸭掌草菇煲	饮食/烹饪/中国烹饪/八大菜系/八大菜系
杂烩锅子	饮食/烹饪/中国烹饪/八大菜系/八大菜系
枣泥糕	饮食/烹饪/中国烹饪/八大菜系/八大菜系
汁鲫鱼	饮食/烹饪/中国烹饪/八大菜系/八大菜系
浙系（浙江菜）	饮食/烹饪/中国烹饪/八大菜系/八大菜系
浙菜	饮食/烹饪/中国烹饪/八大菜系/八大菜系
炸丸子	饮食/烹饪/中国烹饪/八大菜系/八大菜系
炸乳鸽	饮食/烹饪/中国烹饪/八大菜系/八大菜系
炸佛手通脊	饮食/烹饪/中国烹饪/八大菜系/八大菜系
炸卷果儿	饮食/烹饪/中国烹饪/八大菜系/八大菜系
炸大扁	饮食/烹饪/中国烹饪/八大菜系/八大菜系
炸子蟹	饮食/烹饪/中国烹饪/八大菜系/八大菜系
炸木耳	饮食/烹饪/中国烹饪/八大菜系/八大菜系
炸汁儿	饮食/烹饪/中国烹饪/八大菜系/八大菜系
炸海蟹	饮食/烹饪/中国烹饪/八大菜系/八大菜系
炸灌汤丸子	饮食/烹饪/中国烹饪/八大菜系/八大菜系
炸烹儿	饮食/烹饪/中国烹饪/八大菜系/八大菜系
炸烹凤尾虾	饮食/烹饪/中国烹饪/八大菜系/八大菜系
炸烹虾段	饮食/烹饪/中国烹饪/八大菜系/八大菜系
炸素鸡排	饮食/烹饪/中国烹饪/八大菜系/八大菜系
炸紫盖儿	饮食/烹饪/中国烹饪/八大菜系/八大菜系
炸绣球	饮食/烹饪/中国烹饪/八大菜系/八大菜系
炸肉骨碌烹	饮食/烹饪/中国烹饪/八大菜系/八大菜系
炸脂盖	饮食/烹饪/中国烹饪/八大菜系/八大菜系
炸腰花	饮食/烹饪/中国烹饪/八大菜系/八大菜系
炸芝麻里脊	饮食/烹饪/中国烹饪/八大菜系/八大菜系
炸花件儿	饮食/烹饪/中国烹饪/八大菜系/八大菜系
炸菠菜脯	饮食/烹饪/中国烹饪/八大菜系/八大菜系
炸蚕蛹鸡	饮食/烹饪/中国烹饪/八大菜系/八大菜系
炸豆腐	饮食/烹饪/中国烹饪/八大菜系/八大菜系
炸豆腐丸子	饮食/烹饪/中国烹饪/八大菜系/八大菜系
炸软巾	饮食/烹饪/中国烹饪/八大菜系/八大菜系
炸金钩棒	饮食/烹饪/中国烹饪/八大菜系/八大菜系
炸面筋	饮食/烹饪/中国烹饪/八大菜系/八大菜系
炸飞禽	饮食/烹饪/中国烹饪/八大菜系/八大菜系
炸鸡葫芦	饮食/烹饪/中国烹饪/八大菜系/八大菜系
炸鸳鸯嘎渣	饮食/烹饪/中国烹饪/八大菜系/八大菜系
炸鹿尾儿	饮食/烹饪/中国烹饪/八大菜系/八大菜系
炸黄河刀鱼	饮食/烹饪/中国烹饪/八大菜系/八大菜系
炸黄鱼卷	饮食/烹饪/中国烹饪/八大菜系/八大菜系
炸龙凤丝托	饮食/烹饪/中国烹饪/八大菜系/八大菜系
炸龙肠	饮食/烹饪/中国烹饪/八大菜系/八大菜系
煮饽饽锅子	饮食/烹饪/中国烹饪/八大菜系/八大菜系
珍珠海参	饮食/烹饪/中国烹饪/八大菜系/八大菜系
珍珠烩燕窝	饮食/烹饪/中国烹饪/八大菜系/八大菜系
珍珠豆腐羹	饮食/烹饪/中国烹饪/八大菜系/八大菜系
珍珠雪耳	饮食/烹饪/中国烹饪/八大菜系/八大菜系
知味小笼	饮食/烹饪/中国烹饪/八大菜系/八大菜系
砸鱼汤	饮食/烹饪/中国烹饪/八大菜系/八大菜系
糟油猪舌	饮食/烹饪/中国烹饪/八大菜系/八大菜系
糟炒厚鱼片	饮食/烹饪/中国烹饪/八大菜系/八大菜系
糟煨冬笋	饮食/烹饪/中国烹饪/八大菜系/八大菜系
糟熘鱼片	饮食/烹饪/中国烹饪/八大菜系/八大菜系
糟鸭	饮食/烹饪/中国烹饪/八大菜系/八大菜系
紫桂焖大排	饮食/烹饪/中国烹饪/八大菜系/八大菜系
紫香芥	饮食/烹饪/中国烹饪/八大菜系/八大菜系
纸包秀珍菇	饮食/烹饪/中国烹饪/八大菜系/八大菜系
脂油雪花儿菜	饮食/烹饪/中国烹饪/八大菜系/八大菜系
芝麻卷	饮食/烹饪/中国烹饪/八大菜系/八大菜系
芝麻双丝海带	饮食/烹饪/中国烹饪/八大菜系/八大菜系
芝麻锅炸	饮食/烹饪/中国烹饪/八大菜系/八大菜系
芝麻鱼卷	饮食/烹饪/中国烹饪/八大菜系/八大菜系
芝麻鱼球	饮食/烹饪/中国烹饪/八大菜系/八大菜系
蒸三臭	饮食/烹饪/中国烹饪/八大菜系/八大菜系
蒸扒三丝干贝	饮食/烹饪/中国烹饪/八大菜系/八大菜系
蒸熊掌	饮食/烹饪/中国烹饪/八大菜系/八大菜系
蒸羊羔儿	饮食/烹饪/中国烹饪/八大菜系/八大菜系
蒸鹿尾儿	饮食/烹饪/中国烹饪/八大菜系/八大菜系
走油豆鼓扣肉	饮食/烹饪/中国烹饪/八大菜系/八大菜系
醉大转弯	饮食/烹饪/中国烹饪/八大菜系/八大菜系
阿胶酸萝卜炖鸭	饮食/烹饪/中国烹饪/八大菜系/川菜
鹌鹑蛋海参	饮食/烹饪/中国烹饪/八大菜系/川菜
八宝炒年糕	饮食/烹饪/中国烹饪/八大菜系/川菜
冰汁八宝饭	饮食/烹饪/中国烹饪/八大菜系/川菜
冰花士干圈	饮食/烹饪/中国烹饪/八大菜系/川菜
北京水煮鱼	饮食/烹饪/中国烹饪/八大菜系/川菜
巴国玉米糕	饮食/烹饪/中国烹饪/八大菜系/川菜
巴国酸菜鸡豆花	饮食/烹饪/中国烹饪/八大菜系/川菜
巴爷鸡煲	饮食/烹饪/中国烹饪/八大菜系/川菜
扁鹊调养汤	饮食/烹饪/中国烹饪/八大菜系/川菜
扒龙须菜	饮食/烹饪/中国烹饪/八大菜系/川菜
拌猪耳	饮食/烹饪/中国烹饪/八大菜系/川菜
板栗红烧肉	饮食/烹饪/中国烹饪/八大菜系/川菜
棒子骨炖萝卜	饮食/烹饪/中国烹饪/八大菜系/川菜
棒棒鸡	饮食/烹饪/中国烹饪/八大菜系/川菜
棒棒鸡丝	饮食/烹饪/中国烹饪/八大菜系/川菜
爆椒鸡杂	饮食/烹饪/中国烹饪/八大菜系/川菜
玻璃烧麦	饮食/烹饪/中国烹饪/八大菜系/川菜
玻璃鱿鱼	饮食/烹饪/中国烹饪/八大菜系/川菜
白果烧鸡	饮食/烹饪/中国烹饪/八大菜系/川菜
白果苦瓜	饮食/烹饪/中国烹饪/八大菜系/川菜
白水萝卜汤	饮食/烹饪/中国烹饪/八大菜系/川菜
白汁五柳鱼	饮食/烹饪/中国烹饪/八大菜系/川菜
白汁牛肉	饮食/烹饪/中国烹饪/八大菜系/川菜
白汁紫蹄筋	饮食/烹饪/中国烹饪/八大菜系/川菜
白汁菜心	饮食/烹饪/中国烹饪/八大菜系/川菜
白汁鱼肚	饮食/烹饪/中国烹饪/八大菜系/川菜
白油肉片	饮食/烹饪/中国烹饪/八大菜系/川菜
白油肝片	饮食/烹饪/中国烹饪/八大菜系/川菜
白油豆腐	饮食/烹饪/中国烹饪/八大菜系/川菜
白炒三七花田鸡	饮食/烹饪/中国烹饪/八大菜系/川菜
白雪四蔬	饮食/烹饪/中国烹饪/八大菜系/川菜
百仁全鸭	饮食/烹饪/中国烹饪/八大菜系/川菜
百合牛肉	饮食/烹饪/中国烹饪/八大菜系/川菜
碧绿川椒鸡	饮食/烹饪/中国烹饪/八大菜系/川菜
碧绿虾仁	饮食/烹饪/中国烹饪/八大菜系/川菜
芭夯兔	饮食/烹饪/中国烹饪/八大菜系/川菜
菠心金华鸡球	饮食/烹饪/中国烹饪/八大菜系/川菜
菠菜杉	饮食/烹饪/中国烹饪/八大菜系/川菜
菠饺鱼肚	饮食/烹饪/中国烹饪/八大菜系/川菜
菠饺鱿鱼方	饮食/烹饪/中国烹饪/八大菜系/川菜
补血羊肉乌发汤	饮食/烹饪/中国烹饪/八大菜系/川菜
钵钵鸡	饮食/烹饪/中国烹饪/八大菜系/川菜
拌兔丁	饮食/烹饪/中国烹饪/八大菜系/川菜
巴国大排	饮食/烹饪/中国烹饪/八大菜系/川菜
白灼肥牛	饮食/烹饪/中国烹饪/八大菜系/川菜
巴国布衣	饮食/烹饪/中国烹饪/八大菜系/川菜
巴国南瓜饼	饮食/烹饪/中国烹饪/八大菜系/川菜
白汁鸭卷	饮食/烹饪/中国烹饪/八大菜系/川菜
粑粑肉	饮食/烹饪/中国烹饪/八大菜系/川菜
串串香	饮食/烹饪/中国烹饪/八大菜系/川菜
参蒸鳝段	饮食/烹饪/中国烹饪/八大菜系/川菜
参麦团鱼	饮食/烹饪/中国烹饪/八大菜系/川菜
叉烧鱼	饮食/烹饪/中国烹饪/八大菜系/川菜
叉烧鸡	饮食/烹饪/中国烹饪/八大菜系/川菜
川味坊四川美食网	饮食/烹饪/中国烹饪/八大菜系/川菜
川味干烧大虾	饮食/烹饪/中国烹饪/八大菜系/川菜
川味水煮肉片	饮食/烹饪/中国烹饪/八大菜系/川菜
川味牛肉	饮食/烹饪/中国烹饪/八大菜系/川菜
川味糯米饭	饮食/烹饪/中国烹饪/八大菜系/川菜
川味蟹	饮食/烹饪/中国烹饪/八大菜系/川菜
川味豆卷	饮食/烹饪/中国烹饪/八大菜系/川菜
川味饺子	饮食/烹饪/中国烹饪/八大菜系/川菜
川味鲜溜鸡丁	饮食/烹饪/中国烹饪/八大菜系/川菜
川式啤酒鸭	饮食/烹饪/中国烹饪/八大菜系/川菜
川式尖椒爆牛蛙	饮食/烹饪/中国烹饪/八大菜系/川菜
川式蒜泥辣茄条	饮食/烹饪/中国烹饪/八大菜系/川菜
川椒炝黄瓜	饮食/烹饪/中国烹饪/八大菜系/川菜
川椒鸡	饮食/烹饪/中国烹饪/八大菜系/川菜
川椒龙凤球	饮食/烹饪/中国烹饪/八大菜系/川菜
川烧阶梯虾	饮食/烹饪/中国烹饪/八大菜系/川菜
川芎茶	饮食/烹饪/中国烹饪/八大菜系/川菜
川菜	饮食/烹饪/中国烹饪/八大菜系/川菜
川菜回锅肉	饮食/烹饪/中国烹饪/八大菜系/川菜
川菜王	饮食/烹饪/中国烹饪/八大菜系/川菜
川菜的魅力	饮食/烹饪/中国烹饪/八大菜系/川菜
川西肉豆腐	饮食/烹饪/中国烹饪/八大菜系/川菜
川辣蟹	饮食/烹饪/中国烹饪/八大菜系/川菜
川辣黄瓜	饮食/烹饪/中国烹饪/八大菜系/川菜
川香茄子	饮食/烹饪/中国烹饪/八大菜系/川菜
川香辣椒鸡	饮食/烹饪/中国烹饪/八大菜系/川菜
川鱼头火锅	饮食/烹饪/中国烹饪/八大菜系/川菜
彩带鱼头	饮食/烹饪/中国烹饪/八大菜系/川菜
成都子鸡	饮食/烹饪/中国烹饪/八大菜系/川菜
成都常乐美食餐饮文化	饮食/烹饪/中国烹饪/八大菜系/川菜
成都泡椒墨鱼仔	饮食/烹饪/中国烹饪/八大菜系/川菜
成都玉林串串香	饮食/烹饪/中国烹饪/八大菜系/川菜
成都素烩	饮食/烹饪/中国烹饪/八大菜系/川菜
成都蛋汤	饮食/烹饪/中国烹饪/八大菜系/川菜
抄手肉片	饮食/烹饪/中国烹饪/八大菜系/川菜
捶鸡	饮食/烹饪/中国烹饪/八大菜系/川菜
椿芽烘蛋	饮食/烹饪/中国烹饪/八大菜系/川菜
炒杂拌	饮食/烹饪/中国烹饪/八大菜系/川菜
炒空心菜	饮食/烹饪/中国烹饪/八大菜系/川菜
炒素鱼	饮食/烹饪/中国烹饪/八大菜系/川菜
炒豌豆夹	饮食/烹饪/中国烹饪/八大菜系/川菜
炒面线	饮食/烹饪/中国烹饪/八大菜系/川菜
炒香舌片	饮食/烹饪/中国烹饪/八大菜系/川菜
炒鸡什件	饮食/烹饪/中国烹饪/八大菜系/川菜
脆嫩椒油扁豆	饮食/烹饪/中国烹饪/八大菜系/川菜
脆椒小香鸡	饮食/烹饪/中国烹饪/八大菜系/川菜
脆皮桂鱼	饮食/烹饪/中国烹饪/八大菜系/川菜
脆皮烤乳猪	饮食/烹饪/中国烹饪/八大菜系/川菜
脆皮锅魁	饮食/烹饪/中国烹饪/八大菜系/川菜
臭猪肉	饮食/烹饪/中国烹饪/八大菜系/川菜
船娘煨鸡	饮食/烹饪/中国烹饪/八大菜系/川菜
菜丝凉面	饮食/烹饪/中国烹饪/八大菜系/川菜
菜香源川菜馆	饮食/烹饪/中国烹饪/八大菜系/川菜
葱油酥	饮食/烹饪/中国烹饪/八大菜系/川菜
葱爆麻辣牛肚	饮食/烹饪/中国烹饪/八大菜系/川菜
葱辣鱼	饮食/烹饪/中国烹饪/八大菜系/川菜
葱辣鱼条	饮食/烹饪/中国烹饪/八大菜系/川菜
葱辣鱼脯	饮食/烹饪/中国烹饪/八大菜系/川菜
藏红花烩萝卜	饮食/烹饪/中国烹饪/八大菜系/川菜
虫草鸭舌	饮食/烹饪/中国烹饪/八大菜系/川菜
虫草鹌鹑	饮食/烹饪/中国烹饪/八大菜系/川菜
虫草龟蛇汤	饮食/烹饪/中国烹饪/八大菜系/川菜
蚕豆炒虾仁	饮食/烹饪/中国烹饪/八大菜系/川菜
豉椒带子豆腐	饮食/烹饪/中国烹饪/八大菜系/川菜
馋嘴蛙	饮食/烹饪/中国烹饪/八大菜系/川菜
醋椒活鱼	饮食/烹饪/中国烹饪/八大菜系/川菜
醋溜黄瓜	饮食/烹饪/中国烹饪/八大菜系/川菜
醋熘鸡	饮食/烹饪/中国烹饪/八大菜系/川菜
醋熘黄鱼	饮食/烹饪/中国烹饪/八大菜系/川菜
醋辣白菜梗	饮食/烹饪/中国烹饪/八大菜系/川菜
长春蜀园川味	饮食/烹饪/中国烹饪/八大菜系/川菜
陈皮牛肉	饮食/烹饪/中国烹饪/八大菜系/川菜
陈皮鸡	饮食/烹饪/中国烹饪/八大菜系/川菜
陈醋全家福	饮食/烹饪/中国烹饪/八大菜系/川菜
陈醋海蛰头	饮食/烹饪/中国烹饪/八大菜系/川菜
陈麻婆豆腐	饮食/烹饪/中国烹饪/八大菜系/川菜
馋嘴跳跳蛙	饮食/烹饪/中国烹饪/八大菜系/川菜
川冬菜	饮食/烹饪/中国烹饪/八大菜系/川菜
葱烧鲫鱼	饮食/烹饪/中国烹饪/八大菜系/川菜
葱香兔	饮食/烹饪/中国烹饪/八大菜系/川菜
春天的韭菜卷	饮食/烹饪/中国烹饪/八大菜系/川菜
川菜菜谱大全	饮食/烹饪/中国烹饪/八大菜系/川菜
刺猬鱿鱼	饮食/烹饪/中国烹饪/八大菜系/川菜
川式牛排	饮食/烹饪/中国烹饪/八大菜系/川菜
川味烤鱼	饮食/烹饪/中国烹饪/八大菜系/川菜
川式红烧肉	饮食/烹饪/中国烹饪/八大菜系/川菜
川香鳕鱼丁	饮食/烹饪/中国烹饪/八大菜系/川菜
豉椒鸡片	饮食/烹饪/中国烹饪/八大菜系/川菜
丁香鸭	饮食/烹饪/中国烹饪/八大菜系/川菜
东坡墨鱼	饮食/烹饪/中国烹饪/八大菜系/川菜
东坡春鸠脍	饮食/烹饪/中国烹饪/八大菜系/川菜
东坡肘子	饮食/烹饪/中国烹饪/八大菜系/川菜
东坡蒸猪头	饮食/烹饪/中国烹饪/八大菜系/川菜
东坡鳊鱼	饮食/烹饪/中国烹饪/八大菜系/川菜
冬瓜干贝汤	饮食/烹饪/中国烹饪/八大菜系/川菜
冬瓜燕	饮食/烹饪/中国烹饪/八大菜系/川菜
冬瓜竹笋鸡	饮食/烹饪/中国烹饪/八大菜系/川菜
冬笋三黄鸡	饮食/烹饪/中国烹饪/八大菜系/川菜
冬菜扣肉	饮食/烹饪/中国烹饪/八大菜系/川菜
冬菜肉末	饮食/烹饪/中国烹饪/八大菜系/川菜
剁椒魔芋	饮食/烹饪/中国烹饪/八大菜系/川菜
多味黄瓜	饮食/烹饪/中国烹饪/八大菜系/川菜
大千子鸡	饮食/烹饪/中国烹饪/八大菜系/川菜
大肠油菜	饮食/烹饪/中国烹饪/八大菜系/川菜
大蒜干贝	饮食/烹饪/中国烹饪/八大菜系/川菜
大蒜鲇鱼	饮食/烹饪/中国烹饪/八大菜系/川菜
大蒜鲶鱼	饮食/烹饪/中国烹饪/八大菜系/川菜
打老虎	饮食/烹饪/中国烹饪/八大菜系/川菜
担担油茶	饮食/烹饪/中国烹饪/八大菜系/川菜
朵颐辣子鸡	饮食/烹饪/中国烹饪/八大菜系/川菜
杜仲腰花	饮食/烹饪/中国烹饪/八大菜系/川菜
渡金湖	饮食/烹饪/中国烹饪/八大菜系/川菜
灯影牛肉	饮食/烹饪/中国烹饪/八大菜系/川菜
灯影苕片	饮食/烹饪/中国烹饪/八大菜系/川菜
灯草糕	饮食/烹饪/中国烹饪/八大菜系/川菜
炖牛掌	饮食/烹饪/中国烹饪/八大菜系/川菜
炖鸡汁	饮食/烹饪/中国烹饪/八大菜系/川菜
独蒜烧虾仁	饮食/烹饪/中国烹饪/八大菜系/川菜
蛋烘糕	饮食/烹饪/中国烹饪/八大菜系/川菜
蛋酥花仁	饮食/烹饪/中国烹饪/八大菜系/川菜
豆浆挂面	饮食/烹饪/中国烹饪/八大菜系/川菜
豆渣猪头	饮食/烹饪/中国烹饪/八大菜系/川菜
豆瓣卿鱼	饮食/烹饪/中国烹饪/八大菜系/川菜
豆瓣海参	饮食/烹饪/中国烹饪/八大菜系/川菜
豆瓣肘子	饮食/烹饪/中国烹饪/八大菜系/川菜
豆瓣鱼	饮食/烹饪/中国烹饪/八大菜系/川菜
豆瓣鱼条	饮食/烹饪/中国烹饪/八大菜系/川菜
豆瓣鲜鱼	饮食/烹饪/中国烹饪/八大菜系/川菜
豆瓣鲫鱼	饮食/烹饪/中国烹饪/八大菜系/川菜
豆腐鲫鱼	饮食/烹饪/中国烹饪/八大菜系/川菜
豆花鱼	饮食/烹饪/中国烹饪/八大菜系/川菜
豆苗炒虾片	饮食/烹饪/中国烹饪/八大菜系/川菜
豆苗炒鸡片	饮食/烹饪/中国烹饪/八大菜系/川菜
豆苗虾仁	饮食/烹饪/中国烹饪/八大菜系/川菜
豆苗鸡丝	饮食/烹饪/中国烹饪/八大菜系/川菜
豆豉鱼	饮食/烹饪/中国烹饪/八大菜系/川菜
豆鼓鱼	饮食/烹饪/中国烹饪/八大菜系/川菜
剁椒烧鱼头	饮食/烹饪/中国烹饪/八大菜系/川菜
豆瓣鲤鱼	饮食/烹饪/中国烹饪/八大菜系/川菜
大四川火锅城	饮食/烹饪/中国烹饪/八大菜系/川菜
豆瓣全肘	饮食/烹饪/中国烹饪/八大菜系/川菜
豆瓣	饮食/烹饪/中国烹饪/八大菜系/川菜
二姐兔丁	饮食/烹饪/中国烹饪/八大菜系/川菜
鹅黄肉	饮食/烹饪/中国烹饪/八大菜系/川菜
二黄汤鱼	饮食/烹饪/中国烹饪/八大菜系/川菜
佛手排骨	饮食/烹饪/中国烹饪/八大菜系/川菜
凤凰萝卜	饮食/烹饪/中国烹饪/八大菜系/川菜
凤爪	饮食/烹饪/中国烹饪/八大菜系/川菜
凤醉红尘	饮食/烹饪/中国烹饪/八大菜系/川菜
复元汤	饮食/烹饪/中国烹饪/八大菜系/川菜
富顺豆花	饮食/烹饪/中国烹饪/八大菜系/川菜
沸腾羊肉	饮食/烹饪/中国烹饪/八大菜系/川菜
涪陵咸肉	饮食/烹饪/中国烹饪/八大菜系/川菜
番茄炖兔	饮食/烹饪/中国烹饪/八大菜系/川菜
粉皮白肉	饮食/烹饪/中国烹饪/八大菜系/川菜
粉蒸排骨	饮食/烹饪/中国烹饪/八大菜系/川菜
粉蒸肉	饮食/烹饪/中国烹饪/八大菜系/川菜
肥肠豆花	饮食/烹饪/中国烹饪/八大菜系/川菜
脯酥金鱼	饮食/烹饪/中国烹饪/八大菜系/川菜
腐皮虾包	饮食/烹饪/中国烹饪/八大菜系/川菜
芙蓉燕菜	饮食/烹饪/中国烹饪/八大菜系/川菜
翡翠鸭卷	饮食/烹饪/中国烹饪/八大菜系/川菜
粉蒸牛肉	饮食/烹饪/中国烹饪/八大菜系/川菜
粉蒸海参	饮食/烹饪/中国烹饪/八大菜系/川菜
方竹笋烧肉	饮食/烹饪/中国烹饪/八大菜系/川菜
夫妻肺片	饮食/烹饪/中国烹饪/八大菜系/川菜
功德豆腐	饮食/烹饪/中国烹饪/八大菜系/川菜
嘎婆洋芋	饮食/烹饪/中国烹饪/八大菜系/川菜
宫保八爪鱼	饮食/烹饪/中国烹饪/八大菜系/川菜
宫保虾球	饮食/烹饪/中国烹饪/八大菜系/川菜
宫灯鱼丝	饮食/烹饪/中国烹饪/八大菜系/川菜
干烧大虾	饮食/烹饪/中国烹饪/八大菜系/川菜
干烧岩鲤	饮食/烹饪/中国烹饪/八大菜系/川菜
干烧明虾球	饮食/烹饪/中国烹饪/八大菜系/川菜
干烧牛筋	饮食/烹饪/中国烹饪/八大菜系/川菜
干烧辽参	饮食/烹饪/中国烹饪/八大菜系/川菜
干烧雅鱼	饮食/烹饪/中国烹饪/八大菜系/川菜
干烧鱼	饮食/烹饪/中国烹饪/八大菜系/川菜
干烧鱼翅	饮食/烹饪/中国烹饪/八大菜系/川菜
干烧鸡翅	饮食/烹饪/中国烹饪/八大菜系/川菜
干煸兔肉	饮食/烹饪/中国烹饪/八大菜系/川菜
干煸冬笋	饮食/烹饪/中国烹饪/八大菜系/川菜
干煸四季豆	饮食/烹饪/中国烹饪/八大菜系/川菜
干煸牛肉丝	饮食/烹饪/中国烹饪/八大菜系/川菜
干煸神仙蟹	饮食/烹饪/中国烹饪/八大菜系/川菜
干煸肉丝	饮食/烹饪/中国烹饪/八大菜系/川菜
干煸莲藕	饮食/烹饪/中国烹饪/八大菜系/川菜
干煸香菇扁豆	饮食/烹饪/中国烹饪/八大菜系/川菜
干煸鲜笋	饮食/烹饪/中国烹饪/八大菜系/川菜
干煸鳝背	饮食/烹饪/中国烹饪/八大菜系/川菜
干煸鳝鱼	饮食/烹饪/中国烹饪/八大菜系/川菜
干煸鳝鱼丝	饮食/烹饪/中国烹饪/八大菜系/川菜
干煸鸡丁	饮食/烹饪/中国烹饪/八大菜系/川菜
干煽牛肉丝	饮食/烹饪/中国烹饪/八大菜系/川菜
干蒸黄鱼	饮食/烹饪/中国烹饪/八大菜系/川菜
干豇豆芝麻香兔	饮食/烹饪/中国烹饪/八大菜系/川菜
干锅兔	饮食/烹饪/中国烹饪/八大菜系/川菜
广汉缠丝兔	饮食/烹饪/中国烹饪/八大菜系/川菜
归芪炖老母鸡	饮食/烹饪/中国烹饪/八大菜系/川菜
归芪蒸鸡	饮食/烹饪/中国烹饪/八大菜系/川菜
怪味手撕鸡	饮食/烹饪/中国烹饪/八大菜系/川菜
怪味鸡	饮食/烹饪/中国烹饪/八大菜系/川菜
怪味鸡丝	饮食/烹饪/中国烹饪/八大菜系/川菜
怪味鹿肉	饮食/烹饪/中国烹饪/八大菜系/川菜
改版的宫保鸡丁	饮食/烹饪/中国烹饪/八大菜系/川菜
果仁徘骨	饮食/烹饪/中国烹饪/八大菜系/川菜
果仁排骨	饮食/烹饪/中国烹饪/八大菜系/川菜
枸杞海参鸽蛋	饮食/烹饪/中国烹饪/八大菜系/川菜
枸杞红枣老鸡汤	饮食/烹饪/中国烹饪/八大菜系/川菜
桂花核桃冻	饮食/烹饪/中国烹饪/八大菜系/川菜
桂花红烧肉	饮食/烹饪/中国烹饪/八大菜系/川菜
灌肠鸭	饮食/烹饪/中国烹饪/八大菜系/川菜
贵妃鸡火锅	饮食/烹饪/中国烹饪/八大菜系/川菜
贵妃鸡翅	饮食/烹饪/中国烹饪/八大菜系/川菜
锅巴三鲜	饮食/烹饪/中国烹饪/八大菜系/川菜
锅巴肉片	饮食/烹饪/中国烹饪/八大菜系/川菜
锅巴里脊	饮食/烹饪/中国烹饪/八大菜系/川菜
锅煽鱼扇	饮食/烹饪/中国烹饪/八大菜系/川菜
锅贴乌鱼片	饮食/烹饪/中国烹饪/八大菜系/川菜
锅贴鱼片	饮食/烹饪/中国烹饪/八大菜系/川菜
锅贴鸡片	饮食/烹饪/中国烹饪/八大菜系/川菜
锅贴鸭方	饮食/烹饪/中国烹饪/八大菜系/川菜
骨香鹅掌	饮食/烹饪/中国烹饪/八大菜系/川菜
高笋炒肉	饮食/烹饪/中国烹饪/八大菜系/川菜
干烧石斑鱼	饮食/烹饪/中国烹饪/八大菜系/川菜
干烧虾球	饮食/烹饪/中国烹饪/八大菜系/川菜
干煸豆角	饮食/烹饪/中国烹饪/八大菜系/川菜
宫爆螺片	饮食/烹饪/中国烹饪/八大菜系/川菜
枸杞牛鞭汤	饮食/烹饪/中国烹饪/八大菜系/川菜
干煸鸡块	饮食/烹饪/中国烹饪/八大菜系/川菜
合川桃片烧白	饮食/烹饪/中国烹饪/八大菜系/川菜
回味鱼片	饮食/烹饪/中国烹饪/八大菜系/川菜
回锅肉1	饮食/烹饪/中国烹饪/八大菜系/川菜
回锅肉炒蟹	饮食/烹饪/中国烹饪/八大菜系/川菜
回锅鱼片	饮食/烹饪/中国烹饪/八大菜系/川菜
旱蒸脑花鱼	饮食/烹饪/中国烹饪/八大菜系/川菜
浑婆鱼头	饮食/烹饪/中国烹饪/八大菜系/川菜
海底捞	饮食/烹饪/中国烹饪/八大菜系/川菜
海虾麻婆豆腐	饮食/烹饪/中国烹饪/八大菜系/川菜
海鲜川烹	饮食/烹饪/中国烹饪/八大菜系/川菜
海鲜拼盘	饮食/烹饪/中国烹饪/八大菜系/川菜
混堂锅魁	饮食/烹饪/中国烹饪/八大菜系/川菜
滑肉烩鲜竹	饮食/烹饪/中国烹饪/八大菜系/川菜
火热香辣蟹	饮食/烹饪/中国烹饪/八大菜系/川菜
火爆双脆	饮食/烹饪/中国烹饪/八大菜系/川菜
火爆肚头	饮食/烹饪/中国烹饪/八大菜系/川菜
火爆腰块	饮食/烹饪/中国烹饪/八大菜系/川菜
火爆腰花	饮食/烹饪/中国烹饪/八大菜系/川菜
火爆荔枝腰	饮食/烹饪/中国烹饪/八大菜系/川菜
火鞭牛肉	饮食/烹饪/中国烹饪/八大菜系/川菜
烩两色虾丸	饮食/烹饪/中国烹饪/八大菜系/川菜
烩鸭四宝	饮食/烹饪/中国烹饪/八大菜系/川菜
猴头蘑烩凤片	饮食/烹饪/中国烹饪/八大菜系/川菜
猴蘑牛头方	饮食/烹饪/中国烹饪/八大菜系/川菜
糊涂鸡	饮食/烹饪/中国烹饪/八大菜系/川菜
红杞活鱼	饮食/烹饪/中国烹饪/八大菜系/川菜
红杞蒸鸡	饮食/烹饪/中国烹饪/八大菜系/川菜
红枣煨肘	饮食/烹饪/中国烹饪/八大菜系/川菜
红椒爆鲜虾	饮食/烹饪/中国烹饪/八大菜系/川菜
红橘粉蒸牛蛙	饮食/烹饪/中国烹饪/八大菜系/川菜
红油抄手	饮食/烹饪/中国烹饪/八大菜系/川菜
红油抄手酱	饮食/烹饪/中国烹饪/八大菜系/川菜
红油耳片	饮食/烹饪/中国烹饪/八大菜系/川菜
红烧卷筒鸡	饮食/烹饪/中国烹饪/八大菜系/川菜
红烧咕噜肉	饮食/烹饪/中国烹饪/八大菜系/川菜
红烧烤麸	饮食/烹饪/中国烹饪/八大菜系/川菜
红烧熊掌	饮食/烹饪/中国烹饪/八大菜系/川菜
红烧牛掌	饮食/烹饪/中国烹饪/八大菜系/川菜
红烧牛腩	饮食/烹饪/中国烹饪/八大菜系/川菜
红烧猪脑	饮食/烹饪/中国烹饪/八大菜系/川菜
红烧猪腰	饮食/烹饪/中国烹饪/八大菜系/川菜
红烧猪蹄	饮食/烹饪/中国烹饪/八大菜系/川菜
红烧舌尾	饮食/烹饪/中国烹饪/八大菜系/川菜
红烧蹄筋	饮食/烹饪/中国烹饪/八大菜系/川菜
红烧鱼唇	饮食/烹饪/中国烹饪/八大菜系/川菜
红烧龟肉	饮食/烹饪/中国烹饪/八大菜系/川菜
红酒牛腩	饮食/烹饪/中国烹饪/八大菜系/川菜
红酒蔬菜炖牛肉	饮食/烹饪/中国烹饪/八大菜系/川菜
花式麻辣小龙虾	饮食/烹饪/中国烹饪/八大菜系/川菜
花心鸡卷	饮食/烹饪/中国烹饪/八大菜系/川菜
花椒炖醉鸡	饮食/烹饪/中国烹饪/八大菜系/川菜
花椒鱼片	饮食/烹饪/中国烹饪/八大菜系/川菜
花椒鸡丁	饮食/烹饪/中国烹饪/八大菜系/川菜
花汇兔丁	饮食/烹饪/中国烹饪/八大菜系/川菜
荷包豆腐	饮食/烹饪/中国烹饪/八大菜系/川菜
荷包鱿鱼	饮食/烹饪/中国烹饪/八大菜系/川菜
荷叶三蒸	饮食/烹饪/中国烹饪/八大菜系/川菜
荷叶凤脯	饮食/烹饪/中国烹饪/八大菜系/川菜
荷叶排骨	饮食/烹饪/中国烹饪/八大菜系/川菜
荷叶粉蒸鸡	饮食/烹饪/中国烹饪/八大菜系/川菜
荷叶蒸鲫鱼	饮食/烹饪/中国烹饪/八大菜系/川菜
荷花豆腐大虾	饮食/烹饪/中国烹饪/八大菜系/川菜
荷花鸡丁	饮食/烹饪/中国烹饪/八大菜系/川菜
韩式凉拌墨斗鱼	饮食/烹饪/中国烹饪/八大菜系/川菜
韩式煎鱼	饮食/烹饪/中国烹饪/八大菜系/川菜
黄焖鲇鱼头	饮食/烹饪/中国烹饪/八大菜系/川菜
黄焖鸡块	饮食/烹饪/中国烹饪/八大菜系/川菜
黄辣丁鱼火锅	饮食/烹饪/中国烹饪/八大菜系/川菜
黑啤栗子猪肉	饮食/烹饪/中国烹饪/八大菜系/川菜
荷塘情趣	饮食/烹饪/中国烹饪/八大菜系/川菜
红油鸡丝	饮食/烹饪/中国烹饪/八大菜系/川菜
黄瓜干烧肉	饮食/烹饪/中国烹饪/八大菜系/川菜
虎皮海椒	饮食/烹饪/中国烹饪/八大菜系/川菜
《椒盐八宝鸡》	饮食/烹饪/中国烹饪/八大菜系/川菜
京酱风肉	饮食/烹饪/中国烹饪/八大菜系/川菜
吉利大虾	饮食/烹饪/中国烹饪/八大菜系/川菜
君蜀客	饮食/烹饪/中国烹饪/八大菜系/川菜
姜丝牛肉	饮食/烹饪/中国烹饪/八大菜系/川菜
姜汁仔鸡	饮食/烹饪/中国烹饪/八大菜系/川菜
姜汁热味鸡	饮食/烹饪/中国烹饪/八大菜系/川菜
姜汁热窝鸡	饮食/烹饪/中国烹饪/八大菜系/川菜
姜汁热窝鸡蛋	饮食/烹饪/中国烹饪/八大菜系/川菜
姜汁鸭掌	饮食/烹饪/中国烹饪/八大菜系/川菜
姜爆鸭丝	饮食/烹饪/中国烹饪/八大菜系/川菜
姜葱基围虾	饮食/烹饪/中国烹饪/八大菜系/川菜
姜葱螃蟹	饮食/烹饪/中国烹饪/八大菜系/川菜
家常海参	饮食/烹饪/中国烹饪/八大菜系/川菜
家常烤鱼	饮食/烹饪/中国烹饪/八大菜系/川菜
家常豆腐	饮食/烹饪/中国烹饪/八大菜系/川菜
家常鸡块	饮食/烹饪/中国烹饪/八大菜系/川菜
家常版毛血旺	饮食/烹饪/中国烹饪/八大菜系/川菜
椒油鲜味鸡块	饮食/烹饪/中国烹饪/八大菜系/川菜
椒盐八宝鸡	饮食/烹饪/中国烹饪/八大菜系/川菜
椒盐蹄膀	饮食/烹饪/中国烹饪/八大菜系/川菜
椒香孔雀鲳鱼	饮食/烹饪/中国烹饪/八大菜系/川菜
椒麻鸡	饮食/烹饪/中国烹饪/八大菜系/川菜
椒麻鸡片	饮食/烹饪/中国烹饪/八大菜系/川菜
煎苦瓜鸡粒饼	饮食/烹饪/中国烹饪/八大菜系/川菜
犍为酥芙蓉	饮食/烹饪/中国烹饪/八大菜系/川菜
聚三鲜	饮食/烹饪/中国烹饪/八大菜系/川菜
茭白熘鸡片	饮食/烹饪/中国烹饪/八大菜系/川菜
菊花榨菜鱼卷	饮食/烹饪/中国烹饪/八大菜系/川菜
酱油嫩鸡	饮食/烹饪/中国烹饪/八大菜系/川菜
酱爆牛肉	饮食/烹饪/中国烹饪/八大菜系/川菜
酱爆肉	饮食/烹饪/中国烹饪/八大菜系/川菜
酱爆鸭块	饮食/烹饪/中国烹饪/八大菜系/川菜
酱肉丝	饮食/烹饪/中国烹饪/八大菜系/川菜
酱酥桃仁	饮食/烹饪/中国烹饪/八大菜系/川菜
酱香味型	饮食/烹饪/中国烹饪/八大菜系/川菜
金串鱼	饮食/烹饪/中国烹饪/八大菜系/川菜
金笋忌廉东星斑	饮食/烹饪/中国烹饪/八大菜系/川菜
金钩烘蛋	饮食/烹饪/中国烹饪/八大菜系/川菜
金钩青莱头	饮食/烹饪/中国烹饪/八大菜系/川菜
金钩青菜心	饮食/烹饪/中国烹饪/八大菜系/川菜
金钱口蘑汤	饮食/烹饪/中国烹饪/八大菜系/川菜
金钱海参	饮食/烹饪/中国烹饪/八大菜系/川菜
金钱芝麻虾	饮食/烹饪/中国烹饪/八大菜系/川菜
金钱鸡塔	饮食/烹饪/中国烹饪/八大菜系/川菜
金银脑花	饮食/烹饪/中国烹饪/八大菜系/川菜
金银蛋花	饮食/烹饪/中国烹饪/八大菜系/川菜
锦绣时菜塔	饮食/烹饪/中国烹饪/八大菜系/川菜
鸡丝米粉	饮食/烹饪/中国烹饪/八大菜系/川菜
鸡包鱼翅	饮食/烹饪/中国烹饪/八大菜系/川菜
鸡杂	饮食/烹饪/中国烹饪/八大菜系/川菜
鸡汁虾卷	饮食/烹饪/中国烹饪/八大菜系/川菜
鸡火冬瓜燕	饮食/烹饪/中国烹饪/八大菜系/川菜
鸡肉滷味	饮食/烹饪/中国烹饪/八大菜系/川菜
鸡肉甘蓝双拼	饮食/烹饪/中国烹饪/八大菜系/川菜
鸡蓉鲍片	饮食/烹饪/中国烹饪/八大菜系/川菜
鸡蛋花汤	饮食/烹饪/中国烹饪/八大菜系/川菜
鸡豆花	饮食/烹饪/中国烹饪/八大菜系/川菜
鸡蹄花	饮食/烹饪/中国烹饪/八大菜系/川菜
吉庆奶汁鸡	饮食/烹饪/中国烹饪/八大菜系/川菜
江湖菜	饮食/烹饪/中国烹饪/八大菜系/川菜
尖椒兔	饮食/烹饪/中国烹饪/八大菜系/川菜
经典川菜800例	饮食/烹饪/中国烹饪/八大菜系/川菜
椒麻腰片	饮食/烹饪/中国烹饪/八大菜系/川菜
酱蛤蜊	饮食/烹饪/中国烹饪/八大菜系/川菜
家常肉丝千张	饮食/烹饪/中国烹饪/八大菜系/川菜
椒油蘑菇	饮食/烹饪/中国烹饪/八大菜系/川菜
鸡丝拌海蜇	饮食/烹饪/中国烹饪/八大菜系/川菜
金螺展翅	饮食/烹饪/中国烹饪/八大菜系/川菜
家常炒菜	饮食/烹饪/中国烹饪/八大菜系/川菜
酱烧小黄鱼	饮食/烹饪/中国烹饪/八大菜系/川菜
椒麻四件	饮食/烹饪/中国烹饪/八大菜系/川菜
焦耳川式快餐	饮食/烹饪/中国烹饪/八大菜系/川菜
口味龙虾仔	饮食/烹饪/中国烹饪/八大菜系/川菜
口水直流三千尺	饮食/烹饪/中国烹饪/八大菜系/川菜
口水鸡	饮食/烹饪/中国烹饪/八大菜系/川菜
口蘑蒸鸡	饮食/烹饪/中国烹饪/八大菜系/川菜
口袋豆腐	饮食/烹饪/中国烹饪/八大菜系/川菜
开水白菜	饮食/烹饪/中国烹饪/八大菜系/川菜
烤叫化鸡	饮食/烹饪/中国烹饪/八大菜系/川菜
烤扁担肉	饮食/烹饪/中国烹饪/八大菜系/川菜
苦瓜酿肉	饮食/烹饪/中国烹饪/八大菜系/川菜
咖喱山药	饮食/烹饪/中国烹饪/八大菜系/川菜
鲤跃龙门[菜品]	饮食/烹饪/中国烹饪/八大菜系/川菜
冷啖杯	饮食/烹饪/中国烹饪/八大菜系/川菜
凉粉烧排骨	饮食/烹饪/中国烹饪/八大菜系/川菜
凉粉鲫鱼	饮食/烹饪/中国烹饪/八大菜系/川菜
凉面饼子	饮食/烹饪/中国烹饪/八大菜系/川菜
卤肉锅魁	饮食/烹饪/中国烹饪/八大菜系/川菜
卤鸭肫	饮食/烹饪/中国烹饪/八大菜系/川菜
廖记棒棒鸡	饮食/烹饪/中国烹饪/八大菜系/川菜
恋爱豆腐	饮食/烹饪/中国烹饪/八大菜系/川菜
李庄白肉	饮食/烹饪/中国烹饪/八大菜系/川菜
栗子白菜	饮食/烹饪/中国烹饪/八大菜系/川菜
栗杏焖鸡	饮食/烹饪/中国烹饪/八大菜系/川菜
榄菜胡萝卜碎	饮食/烹饪/中国烹饪/八大菜系/川菜
泸州鱼头火锅	饮食/烹饪/中国烹饪/八大菜系/川菜
熘两色鸡米	饮食/烹饪/中国烹饪/八大菜系/川菜
箩粉鱼头豆腐汤	饮食/烹饪/中国烹饪/八大菜系/川菜
老房子元年食府	饮食/烹饪/中国烹饪/八大菜系/川菜
老房子花园餐厅	饮食/烹饪/中国烹饪/八大菜系/川菜
老房子靓家火锅	饮食/烹饪/中国烹饪/八大菜系/川菜
老胡记棒棒鸡	饮食/烹饪/中国烹饪/八大菜系/川菜
老醋蛰头	饮食/烹饪/中国烹饪/八大菜系/川菜
腊肉	饮食/烹饪/中国烹饪/八大菜系/川菜
芦笋牛肉	饮食/烹饪/中国烹饪/八大菜系/川菜
荔枝锅巴肉片	饮食/烹饪/中国烹饪/八大菜系/川菜
荔枝鱿鱼卷	饮食/烹饪/中国烹饪/八大菜系/川菜
萝卜干炒鸡丝	饮食/烹饪/中国烹饪/八大菜系/川菜
萝卜炖羊肉	饮食/烹饪/中国烹饪/八大菜系/川菜
萝卜莲锅汤	饮食/烹饪/中国烹饪/八大菜系/川菜
辣味炸鸡翅	饮食/烹饪/中国烹饪/八大菜系/川菜
辣味煎烤羊肉	饮食/烹饪/中国烹饪/八大菜系/川菜
辣味豆干韭菜花	饮食/烹饪/中国烹饪/八大菜系/川菜
辣味过江鸡	饮食/烹饪/中国烹饪/八大菜系/川菜
辣味金针菇	饮食/烹饪/中国烹饪/八大菜系/川菜
辣子肥肠	饮食/烹饪/中国烹饪/八大菜系/川菜
辣子脆肠	饮食/烹饪/中国烹饪/八大菜系/川菜
辣子鸡	饮食/烹饪/中国烹饪/八大菜系/川菜
辣子鸡丁	饮食/烹饪/中国烹饪/八大菜系/川菜
辣子鸡丁烩饭	饮食/烹饪/中国烹饪/八大菜系/川菜
辣椒泡鱼	饮食/烹饪/中国烹饪/八大菜系/川菜
辣椒碎碎肉	饮食/烹饪/中国烹饪/八大菜系/川菜
辣椒蟹	饮食/烹饪/中国烹饪/八大菜系/川菜
辣汁卤排骨	饮食/烹饪/中国烹饪/八大菜系/川菜
辣汁泥肠	饮食/烹饪/中国烹饪/八大菜系/川菜
辣汁茄丝	饮食/烹饪/中国烹饪/八大菜系/川菜
辣油里脊丝	饮食/烹饪/中国烹饪/八大菜系/川菜
辣炒花蛤	饮食/烹饪/中国烹饪/八大菜系/川菜
辣炒鱿鱼丝	饮食/烹饪/中国烹饪/八大菜系/川菜
辣炸芋头片	饮食/烹饪/中国烹饪/八大菜系/川菜
辣白菜	饮食/烹饪/中国烹饪/八大菜系/川菜
辣豆瓣鱼	饮食/烹饪/中国烹饪/八大菜系/川菜
辣香味鲜豆豉双椒鸡	饮食/烹饪/中国烹饪/八大菜系/川菜
连理双味鱼	饮食/烹饪/中国烹饪/八大菜系/川菜
连锅汤	饮食/烹饪/中国烹饪/八大菜系/川菜
鹿茸牛肉卷	饮食/烹饪/中国烹饪/八大菜系/川菜
黎家竹筒饭	饮食/烹饪/中国烹饪/八大菜系/川菜
龙井鲍片	饮食/烹饪/中国烹饪/八大菜系/川菜
龙井鲍鱼	饮食/烹饪/中国烹饪/八大菜系/川菜
龙眼咸烧白	饮食/烹饪/中国烹饪/八大菜系/川菜
龙眼烧白	饮食/烹饪/中国烹饪/八大菜系/川菜
龙眼甜烧白	饮食/烹饪/中国烹饪/八大菜系/川菜
辣炒牛河	饮食/烹饪/中国烹饪/八大菜系/川菜
老房子民风酒楼	饮食/烹饪/中国烹饪/八大菜系/川菜
龙眼苦瓜	饮食/烹饪/中国烹饪/八大菜系/川菜
凉拌怪味鸡	饮食/烹饪/中国烹饪/八大菜系/川菜
冷锅鱼	饮食/烹饪/中国烹饪/八大菜系/川菜
辣子蒜香骨	饮食/烹饪/中国烹饪/八大菜系/川菜
辣子爆肉	饮食/烹饪/中国烹饪/八大菜系/川菜
辣子肉片	饮食/烹饪/中国烹饪/八大菜系/川菜
萝卜丝炒牛肉丝	饮食/烹饪/中国烹饪/八大菜系/川菜
卢朝华	饮食/烹饪/中国烹饪/八大菜系/川菜
龙眼珊瑚鹿肉	饮食/烹饪/中国烹饪/八大菜系/川菜
明炉三菌猪肝汤	饮食/烹饪/中国烹饪/八大菜系/川菜
明炉鱼头肚片汤	饮食/烹饪/中国烹饪/八大菜系/川菜
木瓜辽参	饮食/烹饪/中国烹饪/八大菜系/川菜
毛肚火锅	饮食/烹饪/中国烹饪/八大菜系/川菜
毛血旺	饮食/烹饪/中国烹饪/八大菜系/川菜
满堂水煮鱼	饮食/烹饪/中国烹饪/八大菜系/川菜
满庭芳酒楼	饮食/烹饪/中国烹饪/八大菜系/川菜
玫瑰凉糍粑	饮食/烹饪/中国烹饪/八大菜系/川菜
玫瑰锅炸	饮食/烹饪/中国烹饪/八大菜系/川菜
米熏仔鸡	饮食/烹饪/中国烹饪/八大菜系/川菜
米熏鱼	饮食/烹饪/中国烹饪/八大菜系/川菜
美味佳肴	饮食/烹饪/中国烹饪/八大菜系/川菜
美味豆腐汤	饮食/烹饪/中国烹饪/八大菜系/川菜
蜜汁山药琢	饮食/烹饪/中国烹饪/八大菜系/川菜
麻圆	饮食/烹饪/中国烹饪/八大菜系/川菜
麻婆豆腐	饮食/烹饪/中国烹饪/八大菜系/川菜
麻婆豆腐1	饮食/烹饪/中国烹饪/八大菜系/川菜
麻婆豆腐鱼	饮食/烹饪/中国烹饪/八大菜系/川菜
麻油火鸡肾	饮食/烹饪/中国烹饪/八大菜系/川菜
麻油鸡	饮食/烹饪/中国烹饪/八大菜系/川菜
麻辣冬瓜	饮食/烹饪/中国烹饪/八大菜系/川菜
麻辣冻豆腐	饮食/烹饪/中国烹饪/八大菜系/川菜
麻辣啤酒鸭	饮食/烹饪/中国烹饪/八大菜系/川菜
麻辣干煸兔丁	饮食/烹饪/中国烹饪/八大菜系/川菜
麻辣干锅面筋	饮食/烹饪/中国烹饪/八大菜系/川菜
麻辣牛肉	饮食/烹饪/中国烹饪/八大菜系/川菜
麻辣牛肉丝	饮食/烹饪/中国烹饪/八大菜系/川菜
麻辣牛肉豆腐	饮食/烹饪/中国烹饪/八大菜系/川菜
麻辣猪肉干	饮食/烹饪/中国烹饪/八大菜系/川菜
麻辣猪肝	饮食/烹饪/中国烹饪/八大菜系/川菜
麻辣田螺	饮食/烹饪/中国烹饪/八大菜系/川菜
麻辣白菜	饮食/烹饪/中国烹饪/八大菜系/川菜
麻辣红萝卜丝	饮食/烹饪/中国烹饪/八大菜系/川菜
麻辣肉丁	饮食/烹饪/中国烹饪/八大菜系/川菜
麻辣肉片	饮食/烹饪/中国烹饪/八大菜系/川菜
麻辣诱惑蛙	饮食/烹饪/中国烹饪/八大菜系/川菜
麻辣香水鱼	饮食/烹饪/中国烹饪/八大菜系/川菜
麻辣鳝片	饮食/烹饪/中国烹饪/八大菜系/川菜
麻辣鸡肫毛豆	饮食/烹饪/中国烹饪/八大菜系/川菜
麻辣黄鳝	饮食/烹饪/中国烹饪/八大菜系/川菜
麻酱凤尾	饮食/烹饪/中国烹饪/八大菜系/川菜
麻酱笋尖	饮食/烹饪/中国烹饪/八大菜系/川菜
麻酱腰片	饮食/烹饪/中国烹饪/八大菜系/川菜
麻辣萝卜干	饮食/烹饪/中国烹饪/八大菜系/川菜
麻辣花椒鸡	饮食/烹饪/中国烹饪/八大菜系/川菜
麻辣鲨鱼肚	饮食/烹饪/中国烹饪/八大菜系/川菜
麻辣蛋羹鱼	饮食/烹饪/中国烹饪/八大菜系/川菜
蜜柚烧牛蛙	饮食/烹饪/中国烹饪/八大菜系/川菜
明虾烧粉丝	饮食/烹饪/中国烹饪/八大菜系/川菜
美味川菜	饮食/烹饪/中国烹饪/八大菜系/川菜
农家绿豆花	饮食/烹饪/中国烹饪/八大菜系/川菜
南乳排叉	饮食/烹饪/中国烹饪/八大菜系/川菜
南乳脆香鸡	饮食/烹饪/中国烹饪/八大菜系/川菜
南排杂烩	饮食/烹饪/中国烹饪/八大菜系/川菜
南荠烧鸭丁	饮食/烹饪/中国烹饪/八大菜系/川菜
柠檬黄瓜条	饮食/烹饪/中国烹饪/八大菜系/川菜
牛佛烘肘	饮食/烹饪/中国烹饪/八大菜系/川菜
牛肉馅饼	饮食/烹饪/中国烹饪/八大菜系/川菜
牛肚火锅	饮食/烹饪/中国烹饪/八大菜系/川菜
牛膝蹄筋	饮食/烹饪/中国烹饪/八大菜系/川菜
牛蛙火锅	饮食/烹饪/中国烹饪/八大菜系/川菜
酿青椒	饮食/烹饪/中国烹饪/八大菜系/川菜
柠汁菠萝鱼	饮食/烹饪/中国烹饪/八大菜系/川菜
南充冬菜	饮食/烹饪/中国烹饪/八大菜系/川菜
南京老灶兴餐饮管理有	饮食/烹饪/中国烹饪/八大菜系/川菜
平都牛肉松	饮食/烹饪/中国烹饪/八大菜系/川菜
庖丁府盐边牛肉	饮食/烹饪/中国烹饪/八大菜系/川菜
泡 菜 鱼	饮食/烹饪/中国烹饪/八大菜系/川菜
泡五香黄瓜	饮食/烹饪/中国烹饪/八大菜系/川菜
泡凤爪	饮食/烹饪/中国烹饪/八大菜系/川菜
泡四季豆	饮食/烹饪/中国烹饪/八大菜系/川菜
泡嫩姜	饮食/烹饪/中国烹饪/八大菜系/川菜
泡子姜	饮食/烹饪/中国烹饪/八大菜系/川菜
泡椒乳鸽	饮食/烹饪/中国烹饪/八大菜系/川菜
泡椒墨鱼仔	饮食/烹饪/中国烹饪/八大菜系/川菜
泡椒江团	饮食/烹饪/中国烹饪/八大菜系/川菜
泡椒河鳗	饮食/烹饪/中国烹饪/八大菜系/川菜
泡椒牛肉丝	饮食/烹饪/中国烹饪/八大菜系/川菜
泡椒腰花	饮食/烹饪/中国烹饪/八大菜系/川菜
泡椒蒸水鱼	饮食/烹饪/中国烹饪/八大菜系/川菜
泡椒豆腐	饮食/烹饪/中国烹饪/八大菜系/川菜
泡椒鸡杂	饮食/烹饪/中国烹饪/八大菜系/川菜
泡椒鸡片	饮食/烹饪/中国烹饪/八大菜系/川菜
泡椒黄辣丁	饮食/烹饪/中国烹饪/八大菜系/川菜
泡粑	饮食/烹饪/中国烹饪/八大菜系/川菜
泡莱鲫鱼	饮食/烹饪/中国烹饪/八大菜系/川菜
泡菜炒肉末	饮食/烹饪/中国烹饪/八大菜系/川菜
泡菜爆河虾	饮食/烹饪/中国烹饪/八大菜系/川菜
泡菜肉末	饮食/烹饪/中国烹饪/八大菜系/川菜
泡菜鱼	饮食/烹饪/中国烹饪/八大菜系/川菜
泡菜鹅肠	饮食/烹饪/中国烹饪/八大菜系/川菜
泡萝卜条	饮食/烹饪/中国烹饪/八大菜系/川菜
泡辣椒	饮食/烹饪/中国烹饪/八大菜系/川菜
泡酸辣萝卜	饮食/烹饪/中国烹饪/八大菜系/川菜
浦江蟹羹	饮食/烹饪/中国烹饪/八大菜系/川菜
牌坊面	饮食/烹饪/中国烹饪/八大菜系/川菜
蒲江蟹羹	饮食/烹饪/中国烹饪/八大菜系/川菜
飘香浮水鱼	饮食/烹饪/中国烹饪/八大菜系/川菜
飘香猪脆骨	饮食/烹饪/中国烹饪/八大菜系/川菜
泡椒姜爆鸡	饮食/烹饪/中国烹饪/八大菜系/川菜
泡菜参蟹	饮食/烹饪/中国烹饪/八大菜系/川菜
泡椒肉丝	饮食/烹饪/中国烹饪/八大菜系/川菜
七星鱼丸汤	饮食/烹饪/中国烹饪/八大菜系/川菜
乾坤蒸狗	饮食/烹饪/中国烹饪/八大菜系/川菜
清水白菜	饮食/烹饪/中国烹饪/八大菜系/川菜
清汤圆子	饮食/烹饪/中国烹饪/八大菜系/川菜
清汤柳叶燕菜	饮食/烹饪/中国烹饪/八大菜系/川菜
清汤燕菜	饮食/烹饪/中国烹饪/八大菜系/川菜
清汤群蟹	饮食/烹饪/中国烹饪/八大菜系/川菜
清汤鸡蒙冬菇	饮食/烹饪/中国烹饪/八大菜系/川菜
清蒸江团	饮食/烹饪/中国烹饪/八大菜系/川菜
清蒸甲鱼	饮食/烹饪/中国烹饪/八大菜系/川菜
清蒸青鳝	饮食/烹饪/中国烹饪/八大菜系/川菜
清蒸鸭子	饮食/烹饪/中国烹饪/八大菜系/川菜
炝炒油菜苔	饮食/烹饪/中国烹饪/八大菜系/川菜
炝莲白卷	饮食/烹饪/中国烹饪/八大菜系/川菜
炝黄瓜	饮食/烹饪/中国烹饪/八大菜系/川菜
炝黄瓜条	饮食/烹饪/中国烹饪/八大菜系/川菜
秦妈老火锅	饮食/烹饪/中国烹饪/八大菜系/川菜
芪烧活鱼	饮食/烹饪/中国烹饪/八大菜系/川菜
芪蒸鹌鹑	饮食/烹饪/中国烹饪/八大菜系/川菜
芹菜回锅肉	饮食/烹饪/中国烹饪/八大菜系/川菜
芹菜红萝卜炒牛肉	饮食/烹饪/中国烹饪/八大菜系/川菜
芹黄烧鱼条	饮食/烹饪/中国烹饪/八大菜系/川菜
芹黄鱼丝	饮食/烹饪/中国烹饪/八大菜系/川菜
茄汁鱼卷	饮食/烹饪/中国烹饪/八大菜系/川菜
茄汤焗香鸡	饮食/烹饪/中国烹饪/八大菜系/川菜
荞面拌拐肉	饮食/烹饪/中国烹饪/八大菜系/川菜
青椒塞肉	饮食/烹饪/中国烹饪/八大菜系/川菜
青椒牛肉丝	饮食/烹饪/中国烹饪/八大菜系/川菜
青椒皮蛋	饮食/烹饪/中国烹饪/八大菜系/川菜
青椒茄泥	饮食/烹饪/中国烹饪/八大菜系/川菜
青菠面	饮食/烹饪/中国烹饪/八大菜系/川菜
青蒜回锅肉	饮食/烹饪/中国烹饪/八大菜系/川菜
青蟹溜黄蛋	饮食/烹饪/中国烹饪/八大菜系/川菜
青城仙斋	饮食/烹饪/中国烹饪/八大菜系/川菜
乔外婆	饮食/烹饪/中国烹饪/八大菜系/川菜
茄汁龙虾球	饮食/烹饪/中国烹饪/八大菜系/川菜
燃面	饮食/烹饪/中国烹饪/八大菜系/川菜
瓤甜椒	饮食/烹饪/中国烹饪/八大菜系/川菜
肉桂核桃酥	饮食/烹饪/中国烹饪/八大菜系/川菜
蓉城鸳鸯卷	饮食/烹饪/中国烹饪/八大菜系/川菜
软炸兔糕	饮食/烹饪/中国烹饪/八大菜系/川菜
软炸虾糕	饮食/烹饪/中国烹饪/八大菜系/川菜
软炸鸡肝	饮食/烹饪/中国烹饪/八大菜系/川菜
软烧仔鲇	饮食/烹饪/中国烹饪/八大菜系/川菜
软炸全蝎	饮食/烹饪/中国烹饪/八大菜系/川菜
三丁野菜	饮食/烹饪/中国烹饪/八大菜系/川菜
三七蒸鸡	饮食/烹饪/中国烹饪/八大菜系/川菜
三丝鱼翅	饮食/烹饪/中国烹饪/八大菜系/川菜
三味薏米羹	饮食/烹饪/中国烹饪/八大菜系/川菜
三杯鸡	饮食/烹饪/中国烹饪/八大菜系/川菜
三椒戏牛尾	饮食/烹饪/中国烹饪/八大菜系/川菜
三菌炖鸡	饮食/烹饪/中国烹饪/八大菜系/川菜
三鲜脱骨鱼	饮食/烹饪/中国烹饪/八大菜系/川菜
三鲜锅粑	饮食/烹饪/中国烹饪/八大菜系/川菜
十全乌鸡汤	饮食/烹饪/中国烹饪/八大菜系/川菜
十全炆补汤	饮食/烹饪/中国烹饪/八大菜系/川菜
双仁浮皮	饮食/烹饪/中国烹饪/八大菜系/川菜
双味珍珠元子	饮食/烹饪/中国烹饪/八大菜系/川菜
双味蹄筋	饮食/烹饪/中国烹饪/八大菜系/川菜
双椒脆鱼片	饮食/烹饪/中国烹饪/八大菜系/川菜
双色玫瑰鱼	饮食/烹饪/中国烹饪/八大菜系/川菜
双色白菜	饮食/烹饪/中国烹饪/八大菜系/川菜
四件焖冬笋	饮食/烹饪/中国烹饪/八大菜系/川菜
四味鲍鱼	饮食/烹饪/中国烹饪/八大菜系/川菜
四川冲菜	饮食/烹饪/中国烹饪/八大菜系/川菜
四川凉拌麻辣鸡	饮食/烹饪/中国烹饪/八大菜系/川菜
四川家常酸辣汤	饮食/烹饪/中国烹饪/八大菜系/川菜
四川板鸭	饮食/烹饪/中国烹饪/八大菜系/川菜
四川泡大蒜	饮食/烹饪/中国烹饪/八大菜系/川菜
四川泡菜	饮食/烹饪/中国烹饪/八大菜系/川菜
四川泡辣椒	饮食/烹饪/中国烹饪/八大菜系/川菜
四川烧白	饮食/烹饪/中国烹饪/八大菜系/川菜
四川腊肉	饮食/烹饪/中国烹饪/八大菜系/川菜
四川风味土豆烧排骨	饮食/烹饪/中国烹饪/八大菜系/川菜
山城小汤圆	饮食/烹饪/中国烹饪/八大菜系/川菜
山城棒棒鸡	饮食/烹饪/中国烹饪/八大菜系/川菜
山巴厨子	饮食/烹饪/中国烹饪/八大菜系/川菜
手撕干鱼仔	饮食/烹饪/中国烹饪/八大菜系/川菜
手撕牛肉	饮食/烹饪/中国烹饪/八大菜系/川菜
水八块	饮食/烹饪/中国烹饪/八大菜系/川菜
水晶南瓜	饮食/烹饪/中国烹饪/八大菜系/川菜
水晶橘子	饮食/烹饪/中国烹饪/八大菜系/川菜
水浒肉	饮食/烹饪/中国烹饪/八大菜系/川菜
水煮凤片	饮食/烹饪/中国烹饪/八大菜系/川菜
水煮牛肉	饮食/烹饪/中国烹饪/八大菜系/川菜
水煮肉片	饮食/烹饪/中国烹饪/八大菜系/川菜
水煮鲢鱼	饮食/烹饪/中国烹饪/八大菜系/川菜
沙参心肺汤	饮食/烹饪/中国烹饪/八大菜系/川菜
深圳市新相约宾馆	饮食/烹饪/中国烹饪/八大菜系/川菜
烧鸡丁辣子	饮食/烹饪/中国烹饪/八大菜系/川菜
烧麦穗乌鱼花	饮食/烹饪/中国烹饪/八大菜系/川菜
狮子糕	饮食/烹饪/中国烹饪/八大菜系/川菜
珊瑚雪花鸡	饮食/烹饪/中国烹饪/八大菜系/川菜
生暴盐煎肉	饮食/烹饪/中国烹饪/八大菜系/川菜
生炒蒜苔肉	饮食/烹饪/中国烹饪/八大菜系/川菜
生烧筋尾舌	饮食/烹饪/中国烹饪/八大菜系/川菜
生爆盐煎肉	饮食/烹饪/中国烹饪/八大菜系/川菜
石斛华生米	饮食/烹饪/中国烹饪/八大菜系/川菜
砂锅雅鱼	饮食/烹饪/中国烹饪/八大菜系/川菜
砂锅鱿鱼	饮食/烹饪/中国烹饪/八大菜系/川菜
碎末鸡丁	饮食/烹饪/中国烹饪/八大菜系/川菜
碎米鸡丁	饮食/烹饪/中国烹饪/八大菜系/川菜
碎米鸭舌	饮食/烹饪/中国烹饪/八大菜系/川菜
碎肉酸豆角	饮食/烹饪/中国烹饪/八大菜系/川菜
笋丝鱼香肉丝	饮食/烹饪/中国烹饪/八大菜系/川菜
笋子牛腩煲	饮食/烹饪/中国烹饪/八大菜系/川菜
绍子海参	饮食/烹饪/中国烹饪/八大菜系/川菜
绍子烘蛋	饮食/烹饪/中国烹饪/八大菜系/川菜
臊子豆花	饮食/烹饪/中国烹饪/八大菜系/川菜
艄公号子鱼	饮食/烹饪/中国烹饪/八大菜系/川菜
苏州市布衣寒舍餐饮管	饮食/烹饪/中国烹饪/八大菜系/川菜
苕菜狮子头	饮食/烹饪/中国烹饪/八大菜系/川菜
蒜泥白肉	饮食/烹饪/中国烹饪/八大菜系/川菜
蒜蓉酸辣毛豆	饮食/烹饪/中国烹饪/八大菜系/川菜
蒟蒻凉拌	饮食/烹饪/中国烹饪/八大菜系/川菜
蜀霸虾戏蟹	饮食/烹饪/中国烹饪/八大菜系/川菜
酥炸凤尾鱼	饮食/烹饪/中国烹饪/八大菜系/川菜
酥炸芝麻鱼	饮食/烹饪/中国烹饪/八大菜系/川菜
酥烤大方	饮食/烹饪/中国烹饪/八大菜系/川菜
酥皮鸡饺	饮食/烹饪/中国烹饪/八大菜系/川菜
酥皮龙虾	饮食/烹饪/中国烹饪/八大菜系/川菜
酥盒回锅肉	饮食/烹饪/中国烹饪/八大菜系/川菜
酥肉汤	饮食/烹饪/中国烹饪/八大菜系/川菜
酸汤肥牛	饮食/烹饪/中国烹饪/八大菜系/川菜
酸甜仔姜片	饮食/烹饪/中国烹饪/八大菜系/川菜
酸菜火锅	饮食/烹饪/中国烹饪/八大菜系/川菜
酸菜牛肉丸子	饮食/烹饪/中国烹饪/八大菜系/川菜
酸菜鱼	饮食/烹饪/中国烹饪/八大菜系/川菜
酸辣岩水豆花	饮食/烹饪/中国烹饪/八大菜系/川菜
酸辣牛筋煲	饮食/烹饪/中国烹饪/八大菜系/川菜
酸辣牛肉羹	饮食/烹饪/中国烹饪/八大菜系/川菜
酸辣白菜	饮食/烹饪/中国烹饪/八大菜系/川菜
酸辣臊子蹄筋	饮食/烹饪/中国烹饪/八大菜系/川菜
酸辣蹄筋	饮食/烹饪/中国烹饪/八大菜系/川菜
酸辣鱼	饮食/烹饪/中国烹饪/八大菜系/川菜
酸辣鱿鱼丝	饮食/烹饪/中国烹饪/八大菜系/川菜
酸辣鸭血旺	饮食/烹饪/中国烹饪/八大菜系/川菜
首乌肝片	饮食/烹饪/中国烹饪/八大菜系/川菜
鳝鱼鸡蛋卷	饮食/烹饪/中国烹饪/八大菜系/川菜
双味鱼圆	饮食/烹饪/中国烹饪/八大菜系/川菜
水煮干豆腐	饮食/烹饪/中国烹饪/八大菜系/川菜
酸菜炖鲶鱼	饮食/烹饪/中国烹饪/八大菜系/川菜
臊子烘蛋	饮食/烹饪/中国烹饪/八大菜系/川菜
四味清蒸龙虾	饮食/烹饪/中国烹饪/八大菜系/川菜
三椒炒螺片	饮食/烹饪/中国烹饪/八大菜系/川菜
蒜汁时蔬	饮食/烹饪/中国烹饪/八大菜系/川菜
蒜苗炒肉	饮食/烹饪/中国烹饪/八大菜系/川菜
四川凉粉	饮食/烹饪/中国烹饪/八大菜系/川菜
双椒鸡丁	饮食/烹饪/中国烹饪/八大菜系/川菜
酸辣鸡血	饮食/烹饪/中国烹饪/八大菜系/川菜
酥炸鸭片	饮食/烹饪/中国烹饪/八大菜系/川菜
坛子肉	饮食/烹饪/中国烹饪/八大菜系/川菜
太极双丝	饮食/烹饪/中国烹饪/八大菜系/川菜
太极双泥	饮食/烹饪/中国烹饪/八大菜系/川菜
太白鸭	饮食/烹饪/中国烹饪/八大菜系/川菜
太白鸭子	饮食/烹饪/中国烹饪/八大菜系/川菜
提丝发糕	饮食/烹饪/中国烹饪/八大菜系/川菜
桃杞鸡卷	饮食/烹饪/中国烹饪/八大菜系/川菜
桃米炒蛋	饮食/烹饪/中国烹饪/八大菜系/川菜
桃酥鸡糕	饮食/烹饪/中国烹饪/八大菜系/川菜
氽鸡卷	饮食/烹饪/中国烹饪/八大菜系/川菜
潼川豆豉	饮食/烹饪/中国烹饪/八大菜系/川菜
烫面油糕	饮食/烹饪/中国烹饪/八大菜系/川菜
甜椒肉丝	饮食/烹饪/中国烹饪/八大菜系/川菜
甜烧白	饮食/烹饪/中国烹饪/八大菜系/川菜
甜艾团	饮食/烹饪/中国烹饪/八大菜系/川菜
甜辣回锅肉	饮食/烹饪/中国烹饪/八大菜系/川菜
砣砣鸡肉	饮食/烹饪/中国烹饪/八大菜系/川菜
糖汁烧茄子	饮食/烹饪/中国烹饪/八大菜系/川菜
糖粘羊尾	饮食/烹饪/中国烹饪/八大菜系/川菜
糖醋泡菜	饮食/烹饪/中国烹饪/八大菜系/川菜
糖醋红柿椒	饮食/烹饪/中国烹饪/八大菜系/川菜
糖醋脆皮鱼	饮食/烹饪/中国烹饪/八大菜系/川菜
糖醋鸡圆	饮食/烹饪/中国烹饪/八大菜系/川菜
乌发汤	饮食/烹饪/中国烹饪/八大菜系/川菜
五味明虾片	饮食/烹饪/中国烹饪/八大菜系/川菜
五宝砂锅	饮食/烹饪/中国烹饪/八大菜系/川菜
五彩蟹盒	饮食/烹饪/中国烹饪/八大菜系/川菜
五更肠旺	饮食/烹饪/中国烹饪/八大菜系/川菜
五柳鱼丝	饮食/烹饪/中国烹饪/八大菜系/川菜
五柳鲜鱼	饮食/烹饪/中国烹饪/八大菜系/川菜
五柳黄花鱼	饮食/烹饪/中国烹饪/八大菜系/川菜
五花回锅肉	饮食/烹饪/中国烹饪/八大菜系/川菜
五花肉炒豆腐泡菜	饮食/烹饪/中国烹饪/八大菜系/川菜
五通桥月糕	饮食/烹饪/中国烹饪/八大菜系/川菜
五香熏鱼	饮食/烹饪/中国烹饪/八大菜系/川菜
五香脆皮鸡	饮食/烹饪/中国烹饪/八大菜系/川菜
围炉火锅	饮食/烹饪/中国烹饪/八大菜系/川菜
网油包烧鸡	饮食/烹饪/中国烹饪/八大菜系/川菜
网油腰卷	饮食/烹饪/中国烹饪/八大菜系/川菜
网油鱼包	饮食/烹饪/中国烹饪/八大菜系/川菜
芜爆里脊	饮食/烹饪/中国烹饪/八大菜系/川菜
五彩白肉卷	饮食/烹饪/中国烹饪/八大菜系/川菜
瓦块鸡	饮食/烹饪/中国烹饪/八大菜系/川菜
五花肉回锅	饮食/烹饪/中国烹饪/八大菜系/川菜
咸烧白	饮食/烹饪/中国烹饪/八大菜系/川菜
响铃海参	饮食/烹饪/中国烹饪/八大菜系/川菜
喜沙肉	饮食/烹饪/中国烹饪/八大菜系/川菜
学做川菜	饮食/烹饪/中国烹饪/八大菜系/川菜
小煎鸡	饮食/烹饪/中国烹饪/八大菜系/川菜
小笼粉蒸牛肉	饮食/烹饪/中国烹饪/八大菜系/川菜
小葱烧财鱼	饮食/烹饪/中国烹饪/八大菜系/川菜
新都桂花糕	饮食/烹饪/中国烹饪/八大菜系/川菜
杏仁松果鸡	饮食/烹饪/中国烹饪/八大菜系/川菜
杏仁豆腐	饮食/烹饪/中国烹饪/八大菜系/川菜
杏仁银肺汤	饮食/烹饪/中国烹饪/八大菜系/川菜
湘粤凉拌土豆丝	饮食/烹饪/中国烹饪/八大菜系/川菜
熊掌豆腐	饮食/烹饪/中国烹饪/八大菜系/川菜
玄宗鹿肾长龟汤	饮食/烹饪/中国烹饪/八大菜系/川菜
箱包豆腐	饮食/烹饪/中国烹饪/八大菜系/川菜
细说川菜六种辣	饮食/烹饪/中国烹饪/八大菜系/川菜
绣球鱼翅	饮食/烹饪/中国烹饪/八大菜系/川菜
虾仁冬瓜汤	饮食/烹饪/中国烹饪/八大菜系/川菜
虾肉粉果	饮食/烹饪/中国烹饪/八大菜系/川菜
虾须牛肉	饮食/烹饪/中国烹饪/八大菜系/川菜
西芹百合草莓炒腊肉	饮食/烹饪/中国烹饪/八大菜系/川菜
辛香汇	饮食/烹饪/中国烹饪/八大菜系/川菜
镶碗	饮食/烹饪/中国烹饪/八大菜系/川菜
雪花鸡汤	饮食/烹饪/中国烹饪/八大菜系/川菜
雪花鸡淖	饮食/烹饪/中国烹饪/八大菜系/川菜
雪花鸡焯	饮食/烹饪/中国烹饪/八大菜系/川菜
雪菜捆三辣	饮食/烹饪/中国烹饪/八大菜系/川菜
雪魔芋鸡翅	饮食/烹饪/中国烹饪/八大菜系/川菜
香卤豆干茄脯	饮食/烹饪/中国烹饪/八大菜系/川菜
香干回锅肉	饮食/烹饪/中国烹饪/八大菜系/川菜
香干炒白菜丝	饮食/烹饪/中国烹饪/八大菜系/川菜
香椿白肉丝	饮食/烹饪/中国烹饪/八大菜系/川菜
香油米花糖	饮食/烹饪/中国烹饪/八大菜系/川菜
香炸