AA级绿色食品	饮食
AD奶	饮食
Amovo巧克力	饮食
ampo	饮食
At.Mospher	饮食
《阿鸿食游记》	饮食
BBQ烤牛肋骨	饮食
BoBo烤肉牛扒馆	饮食
BRUUMLMEUR	饮食
《便秘吃什么》	饮食
《别让营养误了孩子未	饮食
不安全食品	饮食
不差钱农家菜馆	饮食
不良饮食习惯	饮食
不醉茶	饮食
Capital M	饮食
CASTELLA蛋糕	饮食
Chendol	饮食
Coca Cola	饮食
COURVOISIE	饮食
参麦糖梨	饮食
《厨师之旅》	饮食
炒大白菜	饮食
《吃主儿》	饮食
《吃好比好吃更重要》	饮食
《吃对了就能大大提高	饮食
《吃心不改》	饮食
《吃来吃去》	饮食
《吃的历史》	饮食
《此味只应天上有》	饮食
《炒鸭肠》	饮食
《炒鹌鹑》	饮食
吃播经济	饮食
《超Q润戚风》	饮食
《餐中随意下饭菜》	饮食
丑鱼美味清蒸鸦片鱼头	饮食
串串香	饮食
串丸子	饮食
串炸牛仔	饮食
串炸里脊	饮食
串烤比目鱼	饮食
串烤海鲜	饮食
串烤肉	饮食
串烤鲜鱿菌	饮食
串烧三明治	饮食
串烧便当	饮食
串烧土司三明治	饮食
串烧扇贝肉	饮食
串烧排骨	饮食
串烧海鲜	饮食
串烧鲟鱼	饮食
串烧鸡柳	饮食
串烧黄鳝	饮食
串煎沙嗲	饮食
串煎馄饨	饮食
串肉意大利面	饮食
DASH饮食	饮食
DEHP毒饮料	饮食
DF冰淇淋	饮食
大骨豆芽汤	饮食
豆浆机做米糊	饮食
《点食成金》	饮食
豆豉	饮食
丁丁辣子鸡	饮食
丁字麸	饮食
丁当鸡	饮食
丁香可乐酱猪蹄	饮食
丁香姜糖	饮食
丁香小鱼	饮食
丁香拌油条	饮食
丁香排骨	饮食
丁香火锅	饮食
丁香炒鱼干	饮食
丁香焖鸭	饮食
丁香肉丝	饮食
丁香肉桂鸭汤	饮食
丁香落地	饮食
丁香虾仁	饮食
丁香野兔肉	饮食
丁香野鸭	饮食
丁香雪梨汤	饮食
丁香鱼南蛮渍	饮食
丁香鱼炒咸菜	饮食
丁香鱼焗蝴蝶面	饮食
丁香鱼饺	饮食
丁香鸭	饮食
丁香鸭子	饮食
东京式厨房	饮食
东京荞麦面	饮食
东京蛋卷寿司	饮食
东京鸡肉卷	饮食
东八区茶餐厅	饮食
东北乱炖	饮食
东北凉拌菜	饮食
东北家常锅包肉	饮食
东北小炒皇	饮食
东北拉皮	饮食
东北焖子	饮食
东北熏干豆腐肉卷	饮食
东北猪肉皮冻	饮食
东北玻璃叶饼	饮食
东北粘豆包	饮食
东北肘子	饮食
东北芥梗	饮食
东北菜	饮食
东北菜芹菜鱼丝	饮食
东北蘸酱菜	饮食
东北虎鑫菜馆	饮食
东北酸菜	饮食
东北食文化	饮食
东北饭包	饮食
东北龙胆	饮食
东华乍	饮食
东南亚鸡肉沙拉	饮食
东园家酒	饮食
东坞山豆腐皮	饮食
东坡墨鱼	饮食
东坡扣肉	饮食
东坡春鸠脍	饮食
东坡烧梅	饮食
东坡牛脯	饮食
东坡狗肉	饮食
东坡糖蒸肉	饮食
东坡肉	饮食
东坡肉泰式炒饭	饮食
东坡肘	饮食
东坡肘子	饮食
东坡腊乳狗	饮食
东坡茄子	饮食
东坡茄子煲	饮食
东坡茶	饮食
东坡蒸猪头	饮食
东坡蜜酒	饮食
东坡豆粥	饮食
东坡酒	饮食
东坡饺	饮食
东坡饼	饮食
东坡鳊鱼	饮食
东壁龙珠	饮食
东安子鸡	饮食
东安鸡	饮食
东尼窖藏莎当妮干白	饮食
东尼至尊赤霞珠干红葡	饮食
东尼赤霞珠干红葡萄酒	饮食
东平烧饼	饮食
东方市师鸡	饮食
东方式子脑浓汤	饮食
东方美人茶	饮食
东星绉纱鱼卷	饮食
东来葱煎饼	饮食
东来顺	饮食
东江东坡宴	饮食
东江卤肉	饮食
东江牛肉丸	饮食
东江瓤豆腐	饮食
东江盐h鸡	饮食
东江盐浸鸡	饮食
东江盐烙鸡	饮食
东江盐焗鸡	饮食
东江菜	饮食
东江豆腐煲	饮食
东江酿豆腐	饮食
东江鱼丸	饮食
东海夫人炖猪手	饮食
东璧龙珠	饮食
东瓜水晶葡萄	饮食
东白春芽茶	饮食
东莞兴荣膳食管理服务	饮食
东莞富盈酒店	饮食
东菱豆浆机	饮食
东营南国风情生态园	饮食
东营大闸蟹	饮食
东阳千祥羊肉	饮食
东阳土鸡煲	饮食
东阳索粉	饮食
丹参桃仁炖鳖鱼	饮食
丹参海蜇煲	饮食
edamame	饮食
E族皇后奶茶	饮食
Food and B	饮食
方便面锅	饮食
《凤尾虾排》	饮食
《非常美食》	饮食
《风行欧罗巴》	饮食
丰化摇蚶	饮食
丰化芋艿头	饮食
丰年灌肠	饮食
丰收玉米	饮食
丰收的果园	饮食
丰收硕果	饮食
丰收秋实	饮食
丰收葡萄酒	饮食
丰收鱼虹	饮食
丰收龙舟	饮食
丰泽园字号	饮食
丰胸美容汤	饮食
丰胸通草汤	饮食
GMO	饮食
个性月饼	饮食
胡子鱼	饮食
《哈佛医学院育儿营养	饮食
《好利来》	饮食
《海派名菜名点》	饮食
《红楼梦》与酒文化	饮食
《胡吃乱想》	饮食
海鲜码头	饮食
《黄帝内经——对症食	饮食
iKitchen	饮食
IPAD点菜	饮食
iPhone饼干	饮食
假饥饿	饮食
《健康宝库茶与健康》	饮食
《健康饮食手书》	饮食
《极致之味：怡兰的1	饮食
《椒盐八宝鸡》	饮食
《煎酿三宝》	饮食
《金酒鸡尾酒袖珍手册	饮食
KFC甜玉米沙拉	饮食
KFC黄金蝴蝶虾	饮食
Kiviak	饮食
L-阿拉伯糖	饮食
La Zebra餐厅	饮食
Le Tobsil餐	饮食
Le Whif	饮食
long	饮食
lozzi	饮食
《旅游世界》	饮食
两吃于贝	饮食
两吃多宝鱼	饮食
两吃大乌鱼	饮食
两吃毛豆	饮食
两吃活虾	饮食
两吃菠菜	饮食
两吃鳜鱼	饮食
两味绿豆汤	饮食
两彩大虾	饮食
两情相悦	饮食
两掺	饮食
两炸豆腐	饮食
两相好	饮食
两虾豆腐	饮食
两香问政山笋	饮食
临刑餐	饮食
临汝药酒	饮食
临沂糁	饮食
临泉粉丝	饮食
临海麦饼	饮食
临淄特色小吃	饮食
临潼醪糟	饮食
临猗酱玉瓜	饮食
临高乳猪	饮食
MARSALA酒	饮食
Merchandis	饮食
Mexican Pu	饮食
Mezzomix	饮食
《梅花粥》	饮食
《美凤有约》	饮食
《美国人饮食指南》	饮食
《美食成都》	饮食
麻辣鸭头	饮食
《蜜蜂产品生产管理规	饮食
《面包新语》	饮食
《你所不知道的葡萄酒	饮食
浓汁盖鱼	饮食
PapaRoti	饮食
PITA口袋饼	饮食
Ponta	饮食
poussin	饮食
POV	饮食
QQ的甜甜圈	饮食
茄子皮蛋	饮食
《轻松调饮养生保健花	饮食
七喜冰凉瓜	饮食
七姐妹酒	饮食
七子饼茶	饮食
七宝供水站	饮食
七宝祛斑饮	饮食
七彩什锦煲	饮食
七彩什锦砂锅	饮食
七彩冻鸭丝	饮食
七彩判扬	饮食
七彩双菇	饮食
七彩干贝汤	饮食
七彩日本冷面	饮食
七彩杂锦煲	饮食
七彩炒肝尖	饮食
七彩炒鲟皮	饮食
七彩烩胗芹	饮食
七彩瓤猪肚	饮食
七彩粉丝赠粉丝	饮食
七彩粥	饮食
七彩粿汁糕	饮食
七彩菊花桂鱼柳	饮食
七彩豆腐	饮食
七彩金盏	饮食
七彩鱼生	饮食
七彩鲑鱼	饮食
七彩鸡丝	饮食
七彩鹿肉面	饮食
七星丸	饮食
七星拼盘	饮食
七星紫蟹	饮食
七星葫芦鸭	饮食
七星螃蟹	饮食
七星鱼丸	饮食
七星鱼丸汤	饮食
七样止渴汤	饮食
七粮液	饮食
《Redbook生活	饮食
Samtaesung	饮食
Scarlett红酒	饮食
Smith Wol	饮食
《上海的吃》	饮食
《世界葡萄酒全书》	饮食
《是议全书》	饮食
《桑葚粥》	饮食
《深层素食主义》	饮食
《生活大参考》	饮食
《瘦身食谱》	饮食
《素食杂谈》	饮食
《舌尖上的中国》	饮食
《苏GOOD》	饮食
《食品真相大揭秘》	饮食
《食得健康》	饮食
三A红提子露酒	饮食
三丁包	饮食
三丁大包	饮食
三丁炒松子	饮食
三丁炒玉米	饮食
三丁炒腰果	饮食
三丁炒饭	饮食
三丁烩白云	饮食
三丁烩虾仁	饮食
三丁玉米	饮食
三丁茭白	饮食
三丁酥合	饮食
三丁野菜	饮食
三七乌骨鸡	饮食
三七全鸡汤	饮食
三七灵芝	饮食
三七蒸鸡	饮食
三七藕蛋汤	饮食
三七蜂蜜核桃茶	饮食
三不粘	饮食
三丝丸子	饮食
三丝南菜	饮食
三丝发菜羹	饮食
三丝干巴菌	饮食
三丝年糕	饮食
三丝扒茄合	饮食
三丝拌洋菜	饮食
三丝拌粉皮	饮食
三丝拌糟鸡	饮食
三丝拌蛏	饮食
三丝拌金针	饮食
三丝汤	饮食
三丝河粉卷	饮食
三丝清炒蟹	饮食
三丝炒蛋	饮食
三丝炒鸽松	饮食
三丝炝花枝	饮食
三丝燕菜	饮食
三丝牛肉卷	饮食
三丝白菜汤	饮食
三丝百灵菇	饮食
三丝眉毛酥	饮食
三丝糊塌子	饮食
三丝素鱼翅	饮食
三丝紫菜汤	饮食
三丝羹	饮食
三丝荞麦凉面	饮食
三丝荷包蛋	饮食
三丝蒸大鳝	饮食
三丝豆苗汤	饮食
三丝银鱼羹	饮食
三丝鱼翅	饮食
三丝鱿鱼	饮食
三丝鲜鱼	饮食
三丝黄花菜	饮食
三丝龙袍	饮食
三个贵州人	饮食
三么台	饮食
三乌鸡	饮食
三人行西餐厅	饮食
三仁龙虾球	饮食
三仙通草汤	饮食
三仙酿上海青	饮食
三元八宝乳鸽	饮食
三元汤	饮食
三元甲鱼	饮食
三全凌汤圆	饮食
三冬汤	饮食
三刀	饮食
三原蓼花糖	饮食
三叶草面包	饮食
三合一咖啡	饮食
三合油香椿面	饮食
三合泥	饮食
三合鱼腥茶	饮食
三味养颜茶	饮食
三味南瓜鸡	饮食
三味拌黄瓜	饮食
三味汤	饮食
三味灯笼虾	饮食
三味炖大鹅	饮食
三味牡丹鱼	饮食
三味玉翡翠	饮食
三味白菜	饮食
三味肠饼	饮食
三味蒸回鱼	饮食
三味蒸鮰鱼	饮食
三味薏米羹	饮食
三味豆腐	饮食
三味锅	饮食
三味黄瓜	饮食
三圆扒海参	饮食
三夏红柿香菇炒肉	饮食
三奇肉	饮食
三套碗	饮食
三套鸭	饮食
三子炖猪腰汤	饮食
三宝汤	饮食
三宝炖仔鸭	饮食
三宝粳米粥	饮食
三宝芙蓉蛋	饮食
三宝酱虾炒西洋菜	饮食
三宝饭便当	饮食
三宝鲍片	饮食
三宝鲜汤	饮食
三层套鸡	饮食
三层色酒杯冻	饮食
三峡龙井	饮食
三彩大虾	饮食
三彩脆皮豆腐	饮食
三彩菠菜	饮食
三才鲜鸡汤	饮食
三文一品汤包	饮食
三文翡翠卷	饮食
三文鱼北极贝鲜虾寿司	饮食
三文鱼圆海带汤	饮食
三文鱼土司卷	饮食
三文鱼头浓汤	饮食
三文鱼木斯丸	饮食
三文鱼沙拉	饮食
三文鱼沙拉卷	饮食
三文鱼炒三丁	饮食
三文鱼生鱼片沙拉	饮食
三文鱼腰果豆腐羹	饮食
三文鱼蒸肉饼	饮食
三文鱼蒸蛋羹	饮食
三文鱼薄饼匹萨	饮食
三文鱼蘑菇汤面	饮食
三文鱼酸奶莳萝酱	饮食
三文鱼醪糟蛋羹	饮食
三文鱼青木瓜沙律	饮食
三文鱼馅饺子	饮食
三文鱼鲜蔬沙拉	饮食
三星麻团	饮食
三杯啤酒鸭	饮食
三杯开屏鱼	饮食
三杯田鸡	饮食
三杯甲鱼	饮食
三杯素鸭	饮食
三杯蒜香虾	饮食
三杯豆腐	饮食
三杯酱瓜	饮食
三杯面轮	饮食
三杯香茶	饮食
三杯鳗鱼	饮食
三杯鸡翼	饮食
三杯鸭	饮食
三林糖酱瓜	饮食
三果美体汁	饮食
三果营养汁	饮食
三果蜜汁	饮食
三样汤	饮食
三椒会脍	饮食
三椒小肥羊	饮食
三椒戏牛尾	饮食
三椒魔芋啤酒鸡	饮食
三汁闷锅	饮食
三沙粿仔	饮食
三河米饺	饮食
三油浸鱼	饮食
三煲乳鸽	饮食
三熟鱼汤	饮食
三片汤	饮食
三物汤	饮食
三珍蟹黄羹	饮食
三瓜瑶柱羹	饮食
三皮丝	饮食
三稔煲荠菜	饮食
三精水	饮食
三美豆腐	饮食
三聚氰胺鸡蛋	饮食
三般茶	饮食
三色冰淇淋	饮食
三色凉面	饮食
三色凤尾虾	饮食
三色印字饼干	饮食
三色口蘑	饮食
三色圈饼	饮食
三色小蛋卷	饮食
三色布丁	饮食
三色布丁杯	饮食
三色披萨	饮食
三色拉花干点	饮食
三色拨鱼儿	饮食
三色明虾片	饮食
三色杂烩粥	饮食
三色杏仁	饮食
三色杏鲍菇	饮食
三色果冻	饮食
三色果汁	饮食
三色桂花汤圆	饮食
三色椒百香果泡菜	饮食
三色水晶包	饮食
三色水果冰	饮食
三色沙虫	饮食
三色炒百合	饮食
三色炸椒	饮食
三色煎蛋	饮食
三色爆肚片	饮食
三色猫耳朵	饮食
三色玉米	饮食
三色甜汤	饮食
三色百叶	饮食
三色糕	饮食
三色羹	饮食
三色肉丸	饮食
三色肝末	饮食
三色芝麻汤圆	饮食
三色花心卷	饮食
三色菊花丝	饮食
三色萝卜丝	饮食
三色萝卜炖牛肉	饮食
三色蒸糕	饮食
三色蒸蛋	饮食
三色蔬菜	饮食
三色蛋	饮食
三色蛋餐盒	饮食
三色豆腐渣	饮食
三色豆芽	饮食
三色酿大芥菜	饮食
三色野生斑	饮食
三色青菜包	饮食
三色鱼丸汤	饮食
三色鱼条	饮食
三色鸡	饮食
三色鸡丁	饮食
三色鸡鱼丸	饮食
三色鸵鸟蛋饼	饮食
三色龙虾	饮食
三花头艳	饮食
三花茶	饮食
三花鱼肚	饮食
三花龙眼茶	饮食
三草养颜汤	饮食
三菇发菜	饮食
三菇浸鱼云	饮食
三菇炒伊面	饮食
三菇炖鱼头	饮食
三菇牛骨髓	饮食
三菇献寿	饮食
三菇猴头	饮食
三菇腐皮云耳蒸牛肝	饮食
三菇菜心	饮食
三菇鲜汤	饮食
三菌炖鸡	饮食
三葱焖排骨	饮食
三蔬蛤蜊汤	饮食
三虾豆腐	饮食
三蛇羹	饮食
三蛇蛤蚧酒	饮食
三衣银耳汤补体液	饮食
三角豆沙包	饮食
三角豆腐	饮食
三角豆腐饺	饮食
三豆炆节瓜	饮食
三豆白鸭汤	饮食
三酱猪肠粉	饮食
三雪蚌花瘦肉汤	饮食
三页饼	饮食
三餐饮食原则	饮食
三香包子	饮食
三香辣椒	饮食
三驱田凉粉	饮食
三鲜	饮食
三鲜仙人菇	饮食
三鲜冬瓜	饮食
三鲜冰豆腐	饮食
三鲜包子	饮食
三鲜参片汤	饮食
三鲜土豆粉煲	饮食
三鲜小馄饨	饮食
三鲜打卤面	饮食
三鲜拌豆腐	饮食
三鲜水饺	饮食
三鲜汁	饮食
三鲜汤饺	饮食
三鲜沙锅	饮食
三鲜火锅	饮食
三鲜炒芦笋	饮食
三鲜炒蕨菜	饮食
三鲜烙盒	饮食
三鲜烧真胗	饮食
三鲜烩拉皮	饮食
三鲜烩鱼唇	饮食
三鲜猴头菇	饮食
三鲜玉米团	饮食
三鲜玉米羹	饮食
三鲜珍珠丸	饮食
三鲜瑶柱	饮食
三鲜砂锅	饮食
三鲜竹筒箜鱼皮饺	饮食
三鲜竹荪	饮食
三鲜素海参	饮食
三鲜素肉块	饮食
三鲜素鱼肚	饮食
三鲜绞股蓝	饮食
三鲜翡翠汤	饮食
三鲜脱骨鱼	饮食
三鲜腐脑	饮食
三鲜芦笋	饮食
三鲜苦瓜汤	饮食
三鲜茄子	饮食
三鲜菜花	饮食
三鲜菠菜面	饮食
三鲜蒸饺	饮食
三鲜蒸鲮鱼球	饮食
三鲜蘑菇	饮食
三鲜豆皮	饮食
三鲜豆腐	饮食
三鲜豆腐火锅	饮食
三鲜豆腐盒	饮食
三鲜豆花汤	饮食
三鲜豆芽	饮食
三鲜酿圆子	饮食
三鲜酿面筋	饮食
三鲜锅塌蛋	饮食
三鲜锅巴	饮食
三鲜锅粑	饮食
三鲜长寿包	饮食
三鲜青豆汤	饮食
三鲜面	饮食
三鲜面片	饮食
三鲜饮	饮食
三鲜鱼唇	饮食
三鲜鱼片	饮食
三鲜鱼翅汤	饮食
三鲜鱼肚	饮食
三鲜鲍鱼	饮食
三鲜鳝汤	饮食
三鲜鸡糕汤	饮食
三鲜鹌鹑蛋	饮食
三鲜龙凤球	饮食
三黄油鸡	饮食
三黄鸡汤	饮食
上下九路	饮食
上四宝粥	饮食
上尊	饮食
上岛咖啡	饮食
上料鱼圆	饮食
上汤双色墨鱼丸	饮食
上汤大白菜	饮食
上汤奶白菜	饮食
上汤娃娃菜	饮食
上汤娃娃菜烩群菇	饮食
上汤扒娃娃菜	饮食
上汤油麦菜	饮食
上汤海蚌	饮食
上汤溜刀鱼脯	饮食
上汤火腿竹笋	饮食
上汤炸面焗花蟹	饮食
上汤焗原螺	饮食
上汤焗鲍鱼	饮食
上汤焗龙虾尾	饮食
上汤熻薄壳	饮食
上汤白菜	饮食
上汤皮蛋西兰花	饮食
上汤竹荪煲	饮食
上汤笋丝	饮食
上汤芝士龙虾	饮食
上汤芥兰	饮食
上汤芦笋竹荪	饮食
上汤菌菇木耳菜	饮食
上汤虾丸	饮食
上汤西兰花	饮食
上汤豌豆苗	饮食
上汤馄饨	饮食
上汤鱼饺	饮食
上汤鲜菇菜饭	饮食
上汤鸡毛菜	饮食
上汤龙凤卷	饮食
上汤龙虾面	饮食
上海卤鸭	饮食
上海咖喱牛肉干	饮食
上海品正餐饮管理有限	饮食
上海四季大酒店	饮食
上海大闸蟹礼券	饮食
上海家常炒酱	饮食
上海小吃	饮食
上海小汤包	饮食
上海春卷	饮食
上海枫泾丁蹄	饮食
上海棠糕	饮食
上海油鸡	饮食
上海熏鱼	饮食
上海猪肉松	饮食
上海白斩鸡	饮食
上海素火腿	饮食
上海色拉	饮食
上海菜	饮食
上海葱烧饼	饮食
上海进京乳腐	饮食
上海酱猪肉	饮食
上海醉蟹	饮食
上海锅贴	饮食
上海锐奇餐饮管理有限	饮食
上海青泡菜	饮食
上海风味清蒸葱油鸡	饮食
上海餐饮行业协会	饮食
上海餐饮行业协会章程	饮食
上海馄饨汤	饮食
上海香酥鸡	饮食
上素仙鹤	饮食
上素菜包	饮食
上饶白眉	饮食
上齐	饮食
什锦咖喱炒面	饮食
世果汇	饮食
世界三大烹饪王国	饮食
世界睾丸烹饪锦标赛	饮食
世界知名洋酒	饮食
世界食品科技大会	饮食
世界饮食文化	饮食
丝娃娃	饮食
丝瓜云耳滚肉片汤	饮食
丝瓜八角炒椰肉	饮食
丝瓜冷面线	饮食
丝瓜双虾水晶粉	饮食
丝瓜墨鱼汤	饮食
丝瓜嫩肉丸	饮食
丝瓜总汇	饮食
丝瓜木耳汤	饮食
丝瓜榨菜粉丝肉片汤	饮食
丝瓜毛豆炒鸡蛋	饮食
丝瓜汪豆腐	饮食
丝瓜沙茶牛肉	饮食
丝瓜油条汤	饮食
丝瓜海米蛋汤	饮食
丝瓜海米鸭蛋汤	饮食
丝瓜海蜇汤	饮食
丝瓜炒毛豆	饮食
丝瓜炒甜椒	饮食
丝瓜炒素	饮食
丝瓜炒紫甘蓝	饮食
丝瓜炒荔枝	饮食
丝瓜炒青豆	饮食
丝瓜炒面筋	饮食
丝瓜炒鸡球	饮食
丝瓜炒黑豆腐竹	饮食
丝瓜炖豆腐	饮食
丝瓜烘蛋汤	饮食
丝瓜烧毛豆米	饮食
丝瓜烩牡蛎	饮食
丝瓜烩蛤蜊	饮食
丝瓜烩面筋	饮食
丝瓜煮虾仁	饮食
丝瓜猪杂汤	饮食
丝瓜猪肝瘦肉汤	饮食
丝瓜瘦肉汤	饮食
丝瓜白果百舍煮银白花	饮食
丝瓜白菜猪瘦肉汤	饮食
丝瓜百合汤	饮食
丝瓜百合猪肝汤	饮食
丝瓜竹荪	饮食
丝瓜竹荪汤	饮食
丝瓜粉丝榨菜肉片汤	饮食
丝瓜络饮	饮食
丝瓜绿豆花汤	饮食
丝瓜肉丝粥	饮食
丝瓜肉片汤	饮食
丝瓜肉片蘑菇汤	饮食
丝瓜草菇滚鲮鱼球汤	饮食
丝瓜草菇肉丸汤	饮食
丝瓜荞麦面	饮食
丝瓜荷包蛋汤	饮食
丝瓜藤猪肉汤	饮食
丝瓜虾皮猪肝汤	饮食
丝瓜西红柿粥	饮食
丝瓜里脊汤	饮食
丝瓜银耳虾汤	饮食
丝瓜馓子汤	饮食
丝瓜鲢鱼汤	饮食
丝瓜鲢鱼滋补汤	饮食
丝瓜鲤鱼汤	饮食
丝袜奶茶	饮食
丝饼	饮食
TLC饮食	饮食
Tomasello蓝	饮食
《天天饮食》	饮食
豚肉海带香菇盅	饮食
《糖尿病行为医学技术	饮食
VELTLINER	饮食
Vieux-Boul	饮食
《吾三吾四的味觉人生	饮食
威斯丽红酒	饮食
《我的川菜生活》	饮食
万三肘子	饮食
万三蹄	饮食
万和春	饮食
万多福开心果	饮食
万子酥鸭	饮食
万字扣肉	饮食
万家飘香	饮食
万寿果生鱼汤	饮食
万寿羹	饮食
万寿菊糖水	饮食
万尼汁	饮食
万年青牌特珍	饮食
万香斋	饮食
万龙献宝	饮食
丸子牛肉萝卜汤	饮食
丸子羊肉汤	饮食
丸子胡萝卜汤	饮食
丸子香菇烩饭	饮食
X4威士忌	饮食
XO海鲜炒饭	饮食
XO肉酱拌面	饮食
XO酱拌冬瓜	饮食
xo酱挪威三文鱼炒饭	饮食
XO酱炒牛柳条	饮食
XO酱炒萝卜糕	饮食
XO酱烤小蚌	饮食
XO酱烧刺参	饮食
XO酱烧干贝虾仁蛋包	饮食
XO酱焗肠头	饮食
XO酱萝卜糕	饮食
XO酱鲜椒煎带子	饮食
XO鲜虾黄瓜	饮食
香菇萝卜骨头汤	饮食
下八珍	饮食
下午茶	饮食
下巴划水	饮食
下水汤	饮食
下水粉丝	饮食
下火大芥菜咸鱼头汤	饮食
《一学就会的意大利美	饮食
《元寶牛蒡》	饮食
《养小录》	饮食
《悦食悦已》	饮食
《扬州食话》	饮食
《育儿营养同步饮食全	饮食
幼儿园膳食计划	饮食
一个女人的神话	饮食
一串心	饮食
一主六配	饮食
一元套餐	饮食
一卵孵双凤	饮食
一口香肠	饮食
一口鲑鱼饺	饮食
一品包子	饮食
一品双味鸡	饮食
一品官燕	饮食
一品富贵鸡	饮食
一品寿桃	饮食
一品山药	饮食
一品料理	饮食
一品柿子	饮食
一品汽锅鸡	饮食
一品海参	饮食
一品海鲜	饮食
一品清汤燕窝	饮食
一品烤乳兔	饮食
一品烧鹿筋	饮食
一品熊掌	饮食
一品爽鱼肚	饮食
一品猴头菇	饮食
一品罗汉鸡	饮食
一品肉	饮食
一品蒸黄鱼	饮食
一品薯包	饮食
一品蟹粥	饮食
一品豆腐	饮食
一品豆腐汤	饮食
一品赤参	饮食
一品配方	饮食
一品酥方	饮食
一品酱方肉	饮食
一品酱羊肉	饮食
一品锅	饮食
一品飘香梅花糕	饮食
一品香大包	饮食
一品鲍鱼	饮食
一品鲜虾菜	饮食
一品鲜贝	饮食
一品鲳	饮食
一品鲳鱼	饮食
一心服务	饮食
一期一会自助烤肉	饮食
一根面	饮食
一桶香	饮食
一滴香	饮食
一碗居	饮食
一窝丝	饮食
一篓油	饮食
一线牵耳	饮食
一罐香	饮食
一锅香干锅鸭头火锅	饮食
一锅鲜	饮食
一锅鸳鸯鱼	饮食
一鱼两味	饮食
与食巨近	饮食
柚子鸡	饮食
严东关五加皮酒	饮食
严州白梨	饮食
有机鸡蛋	饮食
《中华美食》	饮食
《中国名食指南》	饮食
《中国月饼》	饮食
《中老年常见病饮食调	饮食
《准妈妈科学饮食》	饮食
《智慧岛》	饮食
《这样养育孩子最健康	饮食
丈母鱼丸汤	饮食
专业蛋挞	饮食
中乳酪蛋糕	饮食
中医食疗	饮食
中华井	饮食
中华味饭团	饮食
中华第一满汉全席	饮食
中华药膳	饮食
中华菜谱	饮食
中华贡鸡王	饮食
中华食品	饮食
中华食品网	饮食
中华食品论坛	饮食
中华食品魅力榜	饮食
中华饮食	饮食
中国387健康网	饮食
中国人九种体质之吃对	饮食
中国传统节日饮食习俗	饮食
中国八大名酒	饮食
中国八大菜系	饮食
中国冰淇淋	饮食
中国名菜典故	饮食
中国名蟹	饮食
中国国际有机食品和绿	饮食
中国料理	饮食
中国茶道	饮食
中国菜	饮食
中国菜系之乡	饮食
中国酒文化网	饮食
中国零食网	饮食
中国食品饮料网	饮食
中国餐饮产业信息网	饮食
中国饮食文化	饮食
中式三明治	饮食
中式如意蛋卷	饮食
中式小菜	饮食
中式沙拉	饮食
中式炸酱面	饮食
中式牛排	饮食
中式牛柳	饮食
中式牛肉汉堡	饮食
中式猪排饭	饮食
中式猪蹄瓜汤	饮食
中式百宝酿火鸡	饮食
中式红烧猪蹄	饮食
中式苹果派	饮食
中式茄酱意面	饮食
中式蹄扒海参	饮食
中式通心粉	饮食
中式香葱猪蹄	饮食
中江挂面	饮食
中法双松	饮食
中爪腐衣	饮食
中秋大团圆	饮食
中秋福利	饮食
中秋鱼	饮食
中秋鸡	饮食
中筋面粉	饮食
中绿华夏有机食品认证	饮食
中绿集团	饮食
中药八宝鲜鸡汤	饮食
中药茶	饮食
中药零食	饮食
中餐礼仪	饮食
阿胶酸萝卜炖鸭	饮食/2烹饪/2中国烹饪/2八大菜系/川菜
鹌鹑蛋海参	饮食/2烹饪/2中国烹饪/2八大菜系/川菜
八宝炒年糕	饮食/2烹饪/2中国烹饪/2八大菜系/川菜
冰汁八宝饭	饮食/2烹饪/2中国烹饪/2八大菜系/川菜
冰花士干圈	饮食/2烹饪/2中国烹饪/2八大菜系/川菜
北京水煮鱼	饮食/2烹饪/2中国烹饪/2八大菜系/川菜
巴国玉米糕	饮食/2烹饪/2中国烹饪/2八大菜系/川菜
巴国酸菜鸡豆花	饮食/2烹饪/2中国烹饪/2八大菜系/川菜
巴爷鸡煲	饮食/2烹饪/2中国烹饪/2八大菜系/川菜
扁鹊调养汤	饮食/2烹饪/2中国烹饪/2八大菜系/川菜
扒龙须菜	饮食/2烹饪/2中国烹饪/2八大菜系/川菜
拌猪耳	饮食/2烹饪/2中国烹饪/2八大菜系/川菜
板栗红烧肉	饮食/2烹饪/2中国烹饪/2八大菜系/川菜
棒子骨炖萝卜	饮食/2烹饪/2中国烹饪/2八大菜系/川菜
棒棒鸡	饮食/2烹饪/2中国烹饪/2八大菜系/川菜
棒棒鸡丝	饮食/2烹饪/2中国烹饪/2八大菜系/川菜
爆椒鸡杂	饮食/2烹饪/2中国烹饪/2八大菜系/川菜
玻璃烧麦	饮食/2烹饪/2中国烹饪/2八大菜系/川菜
玻璃鱿鱼	饮食/2烹饪/2中国烹饪/2八大菜系/川菜
白果烧鸡	饮食/2烹饪/2中国烹饪/2八大菜系/川菜
白果苦瓜	饮食/2烹饪/2中国烹饪/2八大菜系/川菜
白水萝卜汤	饮食/2烹饪/2中国烹饪/2八大菜系/川菜
白汁五柳鱼	饮食/2烹饪/2中国烹饪/2八大菜系/川菜
白汁牛肉	饮食/2烹饪/2中国烹饪/2八大菜系/川菜
白汁紫蹄筋	饮食/2烹饪/2中国烹饪/2八大菜系/川菜
白汁菜心	饮食/2烹饪/2中国烹饪/2八大菜系/川菜
白汁鱼肚	饮食/2烹饪/2中国烹饪/2八大菜系/川菜
白油肉片	饮食/2烹饪/2中国烹饪/2八大菜系/川菜
白油肝片	饮食/2烹饪/2中国烹饪/2八大菜系/川菜
白油豆腐	饮食/2烹饪/2中国烹饪/2八大菜系/川菜
白炒三七花田鸡	饮食/2烹饪/2中国烹饪/2八大菜系/川菜
白雪四蔬	饮食/2烹饪/2中国烹饪/2八大菜系/川菜
百仁全鸭	饮食/2烹饪/2中国烹饪/2八大菜系/川菜
百合牛肉	饮食/2烹饪/2中国烹饪/2八大菜系/川菜
碧绿川椒鸡	饮食/2烹饪/2中国烹饪/2八大菜系/川菜
碧绿虾仁	饮食/2烹饪/2中国烹饪/2八大菜系/川菜
芭夯兔	饮食/2烹饪/2中国烹饪/2八大菜系/川菜
菠心金华鸡球	饮食/2烹饪/2中国烹饪/2八大菜系/川菜
菠菜杉	饮食/2烹饪/2中国烹饪/2八大菜系/川菜
菠饺鱼肚	饮食/2烹饪/2中国烹饪/2八大菜系/川菜
菠饺鱿鱼方	饮食/2烹饪/2中国烹饪/2八大菜系/川菜
补血羊肉乌发汤	饮食/2烹饪/2中国烹饪/2八大菜系/川菜
钵钵鸡	饮食/2烹饪/2中国烹饪/2八大菜系/川菜
拌兔丁	饮食/2烹饪/2中国烹饪/2八大菜系/川菜
巴国大排	饮食/2烹饪/2中国烹饪/2八大菜系/川菜
白灼肥牛	饮食/2烹饪/2中国烹饪/2八大菜系/川菜
巴国布衣	饮食/2烹饪/2中国烹饪/2八大菜系/川菜
巴国南瓜饼	饮食/2烹饪/2中国烹饪/2八大菜系/川菜
白汁鸭卷	饮食/2烹饪/2中国烹饪/2八大菜系/川菜
粑粑肉	饮食/2烹饪/2中国烹饪/2八大菜系/川菜
串串香	饮食/2烹饪/2中国烹饪/2八大菜系/川菜
参蒸鳝段	饮食/2烹饪/2中国烹饪/2八大菜系/川菜
参麦团鱼	饮食/2烹饪/2中国烹饪/2八大菜系/川菜
叉烧鱼	饮食/2烹饪/2中国烹饪/2八大菜系/川菜
叉烧鸡	饮食/2烹饪/2中国烹饪/2八大菜系/川菜
川味坊四川美食网	饮食/2烹饪/2中国烹饪/2八大菜系/川菜
川味干烧大虾	饮食/2烹饪/2中国烹饪/2八大菜系/川菜
川味水煮肉片	饮食/2烹饪/2中国烹饪/2八大菜系/川菜
川味牛肉	饮食/2烹饪/2中国烹饪/2八大菜系/川菜
川味糯米饭	饮食/2烹饪/2中国烹饪/2八大菜系/川菜
川味蟹	饮食/2烹饪/2中国烹饪/2八大菜系/川菜
川味豆卷	饮食/2烹饪/2中国烹饪/2八大菜系/川菜
川味饺子	饮食/2烹饪/2中国烹饪/2八大菜系/川菜
川味鲜溜鸡丁	饮食/2烹饪/2中国烹饪/2八大菜系/川菜
川式啤酒鸭	饮食/2烹饪/2中国烹饪/2八大菜系/川菜
川式尖椒爆牛蛙	饮食/2烹饪/2中国烹饪/2八大菜系/川菜
川式蒜泥辣茄条	饮食/2烹饪/2中国烹饪/2八大菜系/川菜
川椒炝黄瓜	饮食/2烹饪/2中国烹饪/2八大菜系/川菜
川椒鸡	饮食/2烹饪/2中国烹饪/2八大菜系/川菜
川椒龙凤球	饮食/2烹饪/2中国烹饪/2八大菜系/川菜
川烧阶梯虾	饮食/2烹饪/2中国烹饪/2八大菜系/川菜
川芎茶	饮食/2烹饪/2中国烹饪/2八大菜系/川菜
川菜	饮食/2烹饪/2中国烹饪/2八大菜系/川菜
川菜回锅肉	饮食/2烹饪/2中国烹饪/2八大菜系/川菜
川菜王	饮食/2烹饪/2中国烹饪/2八大菜系/川菜
川菜的魅力	饮食/2烹饪/2中国烹饪/2八大菜系/川菜
川西肉豆腐	饮食/2烹饪/2中国烹饪/2八大菜系/川菜
川辣蟹	饮食/2烹饪/2中国烹饪/2八大菜系/川菜
川辣黄瓜	饮食/2烹饪/2中国烹饪/2八大菜系/川菜
川香茄子	饮食/2烹饪/2中国烹饪/2八大菜系/川菜
川香辣椒鸡	饮食/2烹饪/2中国烹饪/2八大菜系/川菜
川鱼头火锅	饮食/2烹饪/2中国烹饪/2八大菜系/川菜
彩带鱼头	饮食/2烹饪/2中国烹饪/2八大菜系/川菜
成都子鸡	饮食/2烹饪/2中国烹饪/2八大菜系/川菜
成都常乐美食餐饮文化	饮食/2烹饪/2中国烹饪/2八大菜系/川菜
成都泡椒墨鱼仔	饮食/2烹饪/2中国烹饪/2八大菜系/川菜
成都玉林串串香	饮食/2烹饪/2中国烹饪/2八大菜系/川菜
成都素烩	饮食/2烹饪/2中国烹饪/2八大菜系/川菜
成都蛋汤	饮食/2烹饪/2中国烹饪/2八大菜系/川菜
抄手肉片	饮食/2烹饪/2中国烹饪/2八大菜系/川菜
捶鸡	饮食/2烹饪/2中国烹饪/2八大菜系/川菜
椿芽烘蛋	饮食/2烹饪/2中国烹饪/2八大菜系/川菜
炒杂拌	饮食/2烹饪/2中国烹饪/2八大菜系/川菜
炒空心菜	饮食/2烹饪/2中国烹饪/2八大菜系/川菜
炒素鱼	饮食/2烹饪/2中国烹饪/2八大菜系/川菜
炒豌豆夹	饮食/2烹饪/2中国烹饪/2八大菜系/川菜
炒面线	饮食/2烹饪/2中国烹饪/2八大菜系/川菜
炒香舌片	饮食/2烹饪/2中国烹饪/2八大菜系/川菜
炒鸡什件	饮食/2烹饪/2中国烹饪/2八大菜系/川菜
脆嫩椒油扁豆	饮食/2烹饪/2中国烹饪/2八大菜系/川菜
脆椒小香鸡	饮食/2烹饪/2中国烹饪/2八大菜系/川菜
脆皮桂鱼	饮食/2烹饪/2中国烹饪/2八大菜系/川菜
脆皮烤乳猪	饮食/2烹饪/2中国烹饪/2八大菜系/川菜
脆皮锅魁	饮食/2烹饪/2中国烹饪/2八大菜系/川菜
臭猪肉	饮食/2烹饪/2中国烹饪/2八大菜系/川菜
船娘煨鸡	饮食/2烹饪/2中国烹饪/2八大菜系/川菜
菜丝凉面	饮食/2烹饪/2中国烹饪/2八大菜系/川菜
菜香源川菜馆	饮食/2烹饪/2中国烹饪/2八大菜系/川菜
葱油酥	饮食/2烹饪/2中国烹饪/2八大菜系/川菜
葱爆麻辣牛肚	饮食/2烹饪/2中国烹饪/2八大菜系/川菜
葱辣鱼	饮食/2烹饪/2中国烹饪/2八大菜系/川菜
葱辣鱼条	饮食/2烹饪/2中国烹饪/2八大菜系/川菜
葱辣鱼脯	饮食/2烹饪/2中国烹饪/2八大菜系/川菜
藏红花烩萝卜	饮食/2烹饪/2中国烹饪/2八大菜系/川菜
虫草鸭舌	饮食/2烹饪/2中国烹饪/2八大菜系/川菜
虫草鹌鹑	饮食/2烹饪/2中国烹饪/2八大菜系/川菜
虫草龟蛇汤	饮食/2烹饪/2中国烹饪/2八大菜系/川菜
蚕豆炒虾仁	饮食/2烹饪/2中国烹饪/2八大菜系/川菜
豉椒带子豆腐	饮食/2烹饪/2中国烹饪/2八大菜系/川菜
馋嘴蛙	饮食/2烹饪/2中国烹饪/2八大菜系/川菜
醋椒活鱼	饮食/2烹饪/2中国烹饪/2八大菜系/川菜
醋溜黄瓜	饮食/2烹饪/2中国烹饪/2八大菜系/川菜
醋熘鸡	饮食/2烹饪/2中国烹饪/2八大菜系/川菜
醋熘黄鱼	饮食/2烹饪/2中国烹饪/2八大菜系/川菜
醋辣白菜梗	饮食/2烹饪/2中国烹饪/2八大菜系/川菜
长春蜀园川味	饮食/2烹饪/2中国烹饪/2八大菜系/川菜
陈皮牛肉	饮食/2烹饪/2中国烹饪/2八大菜系/川菜
陈皮鸡	饮食/2烹饪/2中国烹饪/2八大菜系/川菜
陈醋全家福	饮食/2烹饪/2中国烹饪/2八大菜系/川菜
陈醋海蛰头	饮食/2烹饪/2中国烹饪/2八大菜系/川菜
陈麻婆豆腐	饮食/2烹饪/2中国烹饪/2八大菜系/川菜
馋嘴跳跳蛙	饮食/2烹饪/2中国烹饪/2八大菜系/川菜
川冬菜	饮食/2烹饪/2中国烹饪/2八大菜系/川菜
葱烧鲫鱼	饮食/2烹饪/2中国烹饪/2八大菜系/川菜
葱香兔	饮食/2烹饪/2中国烹饪/2八大菜系/川菜
春天的韭菜卷	饮食/2烹饪/2中国烹饪/2八大菜系/川菜
川菜菜谱大全	饮食/2烹饪/2中国烹饪/2八大菜系/川菜
刺猬鱿鱼	饮食/2烹饪/2中国烹饪/2八大菜系/川菜
川式牛排	饮食/2烹饪/2中国烹饪/2八大菜系/川菜
川味烤鱼	饮食/2烹饪/2中国烹饪/2八大菜系/川菜
川式红烧肉	饮食/2烹饪/2中国烹饪/2八大菜系/川菜
川香鳕鱼丁	饮食/2烹饪/2中国烹饪/2八大菜系/川菜
豉椒鸡片	饮食/2烹饪/2中国烹饪/2八大菜系/川菜
丁香鸭	饮食/2烹饪/2中国烹饪/2八大菜系/川菜
东坡墨鱼	饮食/2烹饪/2中国烹饪/2八大菜系/川菜
东坡春鸠脍	饮食/2烹饪/2中国烹饪/2八大菜系/川菜
东坡肘子	饮食/2烹饪/2中国烹饪/2八大菜系/川菜
东坡蒸猪头	饮食/2烹饪/2中国烹饪/2八大菜系/川菜
东坡鳊鱼	饮食/2烹饪/2中国烹饪/2八大菜系/川菜
冬瓜干贝汤	饮食/2烹饪/2中国烹饪/2八大菜系/川菜
冬瓜燕	饮食/2烹饪/2中国烹饪/2八大菜系/川菜
冬瓜竹笋鸡	饮食/2烹饪/2中国烹饪/2八大菜系/川菜
冬笋三黄鸡	饮食/2烹饪/2中国烹饪/2八大菜系/川菜
冬菜扣肉	饮食/2烹饪/2中国烹饪/2八大菜系/川菜
冬菜肉末	饮食/2烹饪/2中国烹饪/2八大菜系/川菜
剁椒魔芋	饮食/2烹饪/2中国烹饪/2八大菜系/川菜
多味黄瓜	饮食/2烹饪/2中国烹饪/2八大菜系/川菜
大千子鸡	饮食/2烹饪/2中国烹饪/2八大菜系/川菜
大肠油菜	饮食/2烹饪/2中国烹饪/2八大菜系/川菜
大蒜干贝	饮食/2烹饪/2中国烹饪/2八大菜系/川菜
大蒜鲇鱼	饮食/2烹饪/2中国烹饪/2八大菜系/川菜
大蒜鲶鱼	饮食/2烹饪/2中国烹饪/2八大菜系/川菜
打老虎	饮食/2烹饪/2中国烹饪/2八大菜系/川菜
担担油茶	饮食/2烹饪/2中国烹饪/2八大菜系/川菜
朵颐辣子鸡	饮食/2烹饪/2中国烹饪/2八大菜系/川菜
杜仲腰花	饮食/2烹饪/2中国烹饪/2八大菜系/川菜
渡金湖	饮食/2烹饪/2中国烹饪/2八大菜系/川菜
灯影牛肉	饮食/2烹饪/2中国烹饪/2八大菜系/川菜
灯影苕片	饮食/2烹饪/2中国烹饪/2八大菜系/川菜
灯草糕	饮食/2烹饪/2中国烹饪/2八大菜系/川菜
炖牛掌	饮食/2烹饪/2中国烹饪/2八大菜系/川菜
炖鸡汁	饮食/2烹饪/2中国烹饪/2八大菜系/川菜
独蒜烧虾仁	饮食/2烹饪/2中国烹饪/2八大菜系/川菜
蛋烘糕	饮食/2烹饪/2中国烹饪/2八大菜系/川菜
蛋酥花仁	饮食/2烹饪/2中国烹饪/2八大菜系/川菜
豆浆挂面	饮食/2烹饪/2中国烹饪/2八大菜系/川菜
豆渣猪头	饮食/2烹饪/2中国烹饪/2八大菜系/川菜
豆瓣卿鱼	饮食/2烹饪/2中国烹饪/2八大菜系/川菜
豆瓣海参	饮食/2烹饪/2中国烹饪/2八大菜系/川菜
豆瓣肘子	饮食/2烹饪/2中国烹饪/2八大菜系/川菜
豆瓣鱼	饮食/2烹饪/2中国烹饪/2八大菜系/川菜
豆瓣鱼条	饮食/2烹饪/2中国烹饪/2八大菜系/川菜
豆瓣鲜鱼	饮食/2烹饪/2中国烹饪/2八大菜系/川菜
豆瓣鲫鱼	饮食/2烹饪/2中国烹饪/2八大菜系/川菜
豆腐鲫鱼	饮食/2烹饪/2中国烹饪/2八大菜系/川菜
豆花鱼	饮食/2烹饪/2中国烹饪/2八大菜系/川菜
豆苗炒虾片	饮食/2烹饪/2中国烹饪/2八大菜系/川菜
豆苗炒鸡片	饮食/2烹饪/2中国烹饪/2八大菜系/川菜
豆苗虾仁	饮食/2烹饪/2中国烹饪/2八大菜系/川菜
豆苗鸡丝	饮食/2烹饪/2中国烹饪/2八大菜系/川菜
豆豉鱼	饮食/2烹饪/2中国烹饪/2八大菜系/川菜
豆鼓鱼	饮食/2烹饪/2中国烹饪/2八大菜系/川菜
剁椒烧鱼头	饮食/2烹饪/2中国烹饪/2八大菜系/川菜
豆瓣鲤鱼	饮食/2烹饪/2中国烹饪/2八大菜系/川菜
大四川火锅城	饮食/2烹饪/2中国烹饪/2八大菜系/川菜
豆瓣全肘	饮食/2烹饪/2中国烹饪/2八大菜系/川菜
豆瓣	饮食/2烹饪/2中国烹饪/2八大菜系/川菜
二姐兔丁	饮食/2烹饪/2中国烹饪/2八大菜系/川菜
鹅黄肉	饮食/2烹饪/2中国烹饪/2八大菜系/川菜
二黄汤鱼	饮食/2烹饪/2中国烹饪/2八大菜系/川菜
佛手排骨	饮食/2烹饪/2中国烹饪/2八大菜系/川菜
凤凰萝卜	饮食/2烹饪/2中国烹饪/2八大菜系/川菜
凤爪	饮食/2烹饪/2中国烹饪/2八大菜系/川菜
凤醉红尘	饮食/2烹饪/2中国烹饪/2八大菜系/川菜
复元汤	饮食/2烹饪/2中国烹饪/2八大菜系/川菜
富顺豆花	饮食/2烹饪/2中国烹饪/2八大菜系/川菜
沸腾羊肉	饮食/2烹饪/2中国烹饪/2八大菜系/川菜
涪陵咸肉	饮食/2烹饪/2中国烹饪/2八大菜系/川菜
番茄炖兔	饮食/2烹饪/2中国烹饪/2八大菜系/川菜
粉皮白肉	饮食/2烹饪/2中国烹饪/2八大菜系/川菜
粉蒸排骨	饮食/2烹饪/2中国烹饪/2八大菜系/川菜
粉蒸肉	饮食/2烹饪/2中国烹饪/2八大菜系/川菜
肥肠豆花	饮食/2烹饪/2中国烹饪/2八大菜系/川菜
脯酥金鱼	饮食/2烹饪/2中国烹饪/2八大菜系/川菜
腐皮虾包	饮食/2烹饪/2中国烹饪/2八大菜系/川菜
芙蓉燕菜	饮食/2烹饪/2中国烹饪/2八大菜系/川菜
翡翠鸭卷	饮食/2烹饪/2中国烹饪/2八大菜系/川菜
粉蒸牛肉	饮食/2烹饪/2中国烹饪/2八大菜系/川菜
粉蒸海参	饮食/2烹饪/2中国烹饪/2八大菜系/川菜
方竹笋烧肉	饮食/2烹饪/2中国烹饪/2八大菜系/川菜
夫妻肺片	饮食/2烹饪/2中国烹饪/2八大菜系/川菜
功德豆腐	饮食/2烹饪/2中国烹饪/2八大菜系/川菜
嘎婆洋芋	饮食/2烹饪/2中国烹饪/2八大菜系/川菜
宫保八爪鱼	饮食/2烹饪/2中国烹饪/2八大菜系/川菜
宫保虾球	饮食/2烹饪/2中国烹饪/2八大菜系/川菜
宫灯鱼丝	饮食/2烹饪/2中国烹饪/2八大菜系/川菜
干烧大虾	饮食/2烹饪/2中国烹饪/2八大菜系/川菜
干烧岩鲤	饮食/2烹饪/2中国烹饪/2八大菜系/川菜
干烧明虾球	饮食/2烹饪/2中国烹饪/2八大菜系/川菜
干烧牛筋	饮食/2烹饪/2中国烹饪/2八大菜系/川菜
干烧辽参	饮食/2烹饪/2中国烹饪/2八大菜系/川菜
干烧雅鱼	饮食/2烹饪/2中国烹饪/2八大菜系/川菜
干烧鱼	饮食/2烹饪/2中国烹饪/2八大菜系/川菜
干烧鱼翅	饮食/2烹饪/2中国烹饪/2八大菜系/川菜
干烧鸡翅	饮食/2烹饪/2中国烹饪/2八大菜系/川菜
干煸兔肉	饮食/2烹饪/2中国烹饪/2八大菜系/川菜
干煸冬笋	饮食/2烹饪/2中国烹饪/2八大菜系/川菜
干煸四季豆	饮食/2烹饪/2中国烹饪/2八大菜系/川菜
干煸牛肉丝	饮食/2烹饪/2中国烹饪/2八大菜系/川菜
干煸神仙蟹	饮食/2烹饪/2中国烹饪/2八大菜系/川菜
干煸肉丝	饮食/2烹饪/2中国烹饪/2八大菜系/川菜
干煸莲藕	饮食/2烹饪/2中国烹饪/2八大菜系/川菜
干煸香菇扁豆	饮食/2烹饪/2中国烹饪/2八大菜系/川菜
干煸鲜笋	饮食/2烹饪/2中国烹饪/2八大菜系/川菜
干煸鳝背	饮食/2烹饪/2中国烹饪/2八大菜系/川菜
干煸鳝鱼	饮食/2烹饪/2中国烹饪/2八大菜系/川菜
干煸鳝鱼丝	饮食/2烹饪/2中国烹饪/2八大菜系/川菜
干煸鸡丁	饮食/2烹饪/2中国烹饪/2八大菜系/川菜
干煽牛肉丝	饮食/2烹饪/2中国烹饪/2八大菜系/川菜
干蒸黄鱼	饮食/2烹饪/2中国烹饪/2八大菜系/川菜
干豇豆芝麻香兔	饮食/2烹饪/2中国烹饪/2八大菜系/川菜
干锅兔	饮食/2烹饪/2中国烹饪/2八大菜系/川菜
广汉缠丝兔	饮食/2烹饪/2中国烹饪/2八大菜系/川菜
归芪炖老母鸡	饮食/2烹饪/2中国烹饪/2八大菜系/川菜
归芪蒸鸡	饮食/2烹饪/2中国烹饪/2八大菜系/川菜
怪味手撕鸡	饮食/2烹饪/2中国烹饪/2八大菜系/川菜
怪味鸡	饮食/2烹饪/2中国烹饪/2八大菜系/川菜
怪味鸡丝	饮食/2烹饪/2中国烹饪/2八大菜系/川菜
怪味鹿肉	饮食/2烹饪/2中国烹饪/2八大菜系/川菜
改版的宫保鸡丁	饮食/2烹饪/2中国烹饪/2八大菜系/川菜
果仁徘骨	饮食/2烹饪/2中国烹饪/2八大菜系/川菜
果仁排骨	饮食/2烹饪/2中国烹饪/2八大菜系/川菜
枸杞海参鸽蛋	饮食/2烹饪/2中国烹饪/2八大菜系/川菜
枸杞红枣老鸡汤	饮食/2烹饪/2中国烹饪/2八大菜系/川菜
桂花核桃冻	饮食/2烹饪/2中国烹饪/2八大菜系/川菜
桂花红烧肉	饮食/2烹饪/2中国烹饪/2八大菜系/川菜
灌肠鸭	饮食/2烹饪/2中国烹饪/2八大菜系/川菜
贵妃鸡火锅	饮食/2烹饪/2中国烹饪/2八大菜系/川菜
贵妃鸡翅	饮食/2烹饪/2中国烹饪/2八大菜系/川菜
锅巴三鲜	饮食/2烹饪/2中国烹饪/2八大菜系/川菜
锅巴肉片	饮食/2烹饪/2中国烹饪/2八大菜系/川菜
锅巴里脊	饮食/2烹饪/2中国烹饪/2八大菜系/川菜
锅煽鱼扇	饮食/2烹饪/2中国烹饪/2八大菜系/川菜
锅贴乌鱼片	饮食/2烹饪/2中国烹饪/2八大菜系/川菜
锅贴鱼片	饮食/2烹饪/2中国烹饪/2八大菜系/川菜
锅贴鸡片	饮食/2烹饪/2中国烹饪/2八大菜系/川菜
锅贴鸭方	饮食/2烹饪/2中国烹饪/2八大菜系/川菜
骨香鹅掌	饮食/2烹饪/2中国烹饪/2八大菜系/川菜
高笋炒肉	饮食/2烹饪/2中国烹饪/2八大菜系/川菜
干烧石斑鱼	饮食/2烹饪/2中国烹饪/2八大菜系/川菜
干烧虾球	饮食/2烹饪/2中国烹饪/2八大菜系/川菜
干煸豆角	饮食/2烹饪/2中国烹饪/2八大菜系/川菜
宫爆螺片	饮食/2烹饪/2中国烹饪/2八大菜系/川菜
枸杞牛鞭汤	饮食/2烹饪/2中国烹饪/2八大菜系/川菜
干煸鸡块	饮食/2烹饪/2中国烹饪/2八大菜系/川菜
合川桃片烧白	饮食/2烹饪/2中国烹饪/2八大菜系/川菜
回味鱼片	饮食/2烹饪/2中国烹饪/2八大菜系/川菜
回锅肉1	饮食/2烹饪/2中国烹饪/2八大菜系/川菜
回锅肉炒蟹	饮食/2烹饪/2中国烹饪/2八大菜系/川菜
回锅鱼片	饮食/2烹饪/2中国烹饪/2八大菜系/川菜
旱蒸脑花鱼	饮食/2烹饪/2中国烹饪/2八大菜系/川菜
浑婆鱼头	饮食/2烹饪/2中国烹饪/2八大菜系/川菜
海底捞	饮食/2烹饪/2中国烹饪/2八大菜系/川菜
海虾麻婆豆腐	饮食/2烹饪/2中国烹饪/2八大菜系/川菜
海鲜川烹	饮食/2烹饪/2中国烹饪/2八大菜系/川菜
海鲜拼盘	饮食/2烹饪/2中国烹饪/2八大菜系/川菜
混堂锅魁	饮食/2烹饪/2中国烹饪/2八大菜系/川菜
滑肉烩鲜竹	饮食/2烹饪/2中国烹饪/2八大菜系/川菜
火热香辣蟹	饮食/2烹饪/2中国烹饪/2八大菜系/川菜
火爆双脆	饮食/2烹饪/2中国烹饪/2八大菜系/川菜
火爆肚头	饮食/2烹饪/2中国烹饪/2八大菜系/川菜
火爆腰块	饮食/2烹饪/2中国烹饪/2八大菜系/川菜
火爆腰花	饮食/2烹饪/2中国烹饪/2八大菜系/川菜
火爆荔枝腰	饮食/2烹饪/2中国烹饪/2八大菜系/川菜
火鞭牛肉	饮食/2烹饪/2中国烹饪/2八大菜系/川菜
烩两色虾丸	饮食/2烹饪/2中国烹饪/2八大菜系/川菜
烩鸭四宝	饮食/2烹饪/2中国烹饪/2八大菜系/川菜
猴头蘑烩凤片	饮食/2烹饪/2中国烹饪/2八大菜系/川菜
猴蘑牛头方	饮食/2烹饪/2中国烹饪/2八大菜系/川菜
糊涂鸡	饮食/2烹饪/2中国烹饪/2八大菜系/川菜
红杞活鱼	饮食/2烹饪/2中国烹饪/2八大菜系/川菜
红杞蒸鸡	饮食/2烹饪/2中国烹饪/2八大菜系/川菜
红枣煨肘	饮食/2烹饪/2中国烹饪/2八大菜系/川菜
红椒爆鲜虾	饮食/2烹饪/2中国烹饪/2八大菜系/川菜
红橘粉蒸牛蛙	饮食/2烹饪/2中国烹饪/2八大菜系/川菜
红油抄手	饮食/2烹饪/2中国烹饪/2八大菜系/川菜
红油抄手酱	饮食/2烹饪/2中国烹饪/2八大菜系/川菜
红油耳片	饮食/2烹饪/2中国烹饪/2八大菜系/川菜
红烧卷筒鸡	饮食/2烹饪/2中国烹饪/2八大菜系/川菜
红烧咕噜肉	饮食/2烹饪/2中国烹饪/2八大菜系/川菜
红烧烤麸	饮食/2烹饪/2中国烹饪/2八大菜系/川菜
红烧熊掌	饮食/2烹饪/2中国烹饪/2八大菜系/川菜
红烧牛掌	饮食/2烹饪/2中国烹饪/2八大菜系/川菜
红烧牛腩	饮食/2烹饪/2中国烹饪/2八大菜系/川菜
红烧猪脑	饮食/2烹饪/2中国烹饪/2八大菜系/川菜
红烧猪腰	饮食/2烹饪/2中国烹饪/2八大菜系/川菜
红烧猪蹄	饮食/2烹饪/2中国烹饪/2八大菜系/川菜
红烧舌尾	饮食/2烹饪/2中国烹饪/2八大菜系/川菜
红烧蹄筋	饮食/2烹饪/2中国烹饪/2八大菜系/川菜
红烧鱼唇	饮食/2烹饪/2中国烹饪/2八大菜系/川菜
红烧龟肉	饮食/2烹饪/2中国烹饪/2八大菜系/川菜
红酒牛腩	饮食/2烹饪/2中国烹饪/2八大菜系/川菜
红酒蔬菜炖牛肉	饮食/2烹饪/2中国烹饪/2八大菜系/川菜
花式麻辣小龙虾	饮食/2烹饪/2中国烹饪/2八大菜系/川菜
花心鸡卷	饮食/2烹饪/2中国烹饪/2八大菜系/川菜
花椒炖醉鸡	饮食/2烹饪/2中国烹饪/2八大菜系/川菜
花椒鱼片	饮食/2烹饪/2中国烹饪/2八大菜系/川菜
花椒鸡丁	饮食/2烹饪/2中国烹饪/2八大菜系/川菜
花汇兔丁	饮食/2烹饪/2中国烹饪/2八大菜系/川菜
荷包豆腐	饮食/2烹饪/2中国烹饪/2八大菜系/川菜
荷包鱿鱼	饮食/2烹饪/2中国烹饪/2八大菜系/川菜
荷叶三蒸	饮食/2烹饪/2中国烹饪/2八大菜系/川菜
荷叶凤脯	饮食/2烹饪/2中国烹饪/2八大菜系/川菜
荷叶排骨	饮食/2烹饪/2中国烹饪/2八大菜系/川菜
荷叶粉蒸鸡	饮食/2烹饪/2中国烹饪/2八大菜系/川菜
荷叶蒸鲫鱼	饮食/2烹饪/2中国烹饪/2八大菜系/川菜
荷花豆腐大虾	饮食/2烹饪/2中国烹饪/2八大菜系/川菜
荷花鸡丁	饮食/2烹饪/2中国烹饪/2八大菜系/川菜
韩式凉拌墨斗鱼	饮食/2烹饪/2中国烹饪/2八大菜系/川菜
韩式煎鱼	饮食/2烹饪/2中国烹饪/2八大菜系/川菜
黄焖鲇鱼头	饮食/2烹饪/2中国烹饪/2八大菜系/川菜
黄焖鸡块	饮食/2烹饪/2中国烹饪/2八大菜系/川菜
黄辣丁鱼火锅	饮食/2烹饪/2中国烹饪/2八大菜系/川菜
黑啤栗子猪肉	饮食/2烹饪/2中国烹饪/2八大菜系/川菜
荷塘情趣	饮食/2烹饪/2中国烹饪/2八大菜系/川菜
红油鸡丝	饮食/2烹饪/2中国烹饪/2八大菜系/川菜
黄瓜干烧肉	饮食/2烹饪/2中国烹饪/2八大菜系/川菜
虎皮海椒	饮食/2烹饪/2中国烹饪/2八大菜系/川菜
《椒盐八宝鸡》	饮食/2烹饪/2中国烹饪/2八大菜系/川菜
京酱风肉	饮食/2烹饪/2中国烹饪/2八大菜系/川菜
吉利大虾	饮食/2烹饪/2中国烹饪/2八大菜系/川菜
君蜀客	饮食/2烹饪/2中国烹饪/2八大菜系/川菜
姜丝牛肉	饮食/2烹饪/2中国烹饪/2八大菜系/川菜
姜汁仔鸡	饮食/2烹饪/2中国烹饪/2八大菜系/川菜
姜汁热味鸡	饮食/2烹饪/2中国烹饪/2八大菜系/川菜
姜汁热窝鸡	饮食/2烹饪/2中国烹饪/2八大菜系/川菜
姜汁热窝鸡蛋	饮食/2烹饪/2中国烹饪/2八大菜系/川菜
姜汁鸭掌	饮食/2烹饪/2中国烹饪/2八大菜系/川菜
姜爆鸭丝	饮食/2烹饪/2中国烹饪/2八大菜系/川菜
姜葱基围虾	饮食/2烹饪/2中国烹饪/2八大菜系/川菜
姜葱螃蟹	饮食/2烹饪/2中国烹饪/2八大菜系/川菜
家常海参	饮食/2烹饪/2中国烹饪/2八大菜系/川菜
家常烤鱼	饮食/2烹饪/2中国烹饪/2八大菜系/川菜
家常豆腐	饮食/2烹饪/2中国烹饪/2八大菜系/川菜
家常鸡块	饮食/2烹饪/2中国烹饪/2八大菜系/川菜
家常版毛血旺	饮食/2烹饪/2中国烹饪/2八大菜系/川菜
椒油鲜味鸡块	饮食/2烹饪/2中国烹饪/2八大菜系/川菜
椒盐八宝鸡	饮食/2烹饪/2中国烹饪/2八大菜系/川菜
椒盐蹄膀	饮食/2烹饪/2中国烹饪/2八大菜系/川菜
椒香孔雀鲳鱼	饮食/2烹饪/2中国烹饪/2八大菜系/川菜
椒麻鸡	饮食/2烹饪/2中国烹饪/2八大菜系/川菜
椒麻鸡片	饮食/2烹饪/2中国烹饪/2八大菜系/川菜
煎苦瓜鸡粒饼	饮食/2烹饪/2中国烹饪/2八大菜系/川菜
犍为酥芙蓉	饮食/2烹饪/2中国烹饪/2八大菜系/川菜
聚三鲜	饮食/2烹饪/2中国烹饪/2八大菜系/川菜
茭白熘鸡片	饮食/2烹饪/2中国烹饪/2八大菜系/川菜
菊花榨菜鱼卷	饮食/2烹饪/2中国烹饪/2八大菜系/川菜
酱油嫩鸡	饮食/2烹饪/2中国烹饪/2八大菜系/川菜
酱爆牛肉	饮食/2烹饪/2中国烹饪/2八大菜系/川菜
酱爆肉	饮食/2烹饪/2中国烹饪/2八大菜系/川菜
酱爆鸭块	饮食/2烹饪/2中国烹饪/2八大菜系/川菜
酱肉丝	饮食/2烹饪/2中国烹饪/2八大菜系/川菜
酱酥桃仁	饮食/2烹饪/2中国烹饪/2八大菜系/川菜
酱香味型	饮食/2烹饪/2中国烹饪/2八大菜系/川菜
金串鱼	饮食/2烹饪/2中国烹饪/2八大菜系/川菜
金笋忌廉东星斑	饮食/2烹饪/2中国烹饪/2八大菜系/川菜
金钩烘蛋	饮食/2烹饪/2中国烹饪/2八大菜系/川菜
金钩青莱头	饮食/2烹饪/2中国烹饪/2八大菜系/川菜
金钩青菜心	饮食/2烹饪/2中国烹饪/2八大菜系/川菜
金钱口蘑汤	饮食/2烹饪/2中国烹饪/2八大菜系/川菜
金钱海参	饮食/2烹饪/2中国烹饪/2八大菜系/川菜
金钱芝麻虾	饮食/2烹饪/2中国烹饪/2八大菜系/川菜
金钱鸡塔	饮食/2烹饪/2中国烹饪/2八大菜系/川菜
金银脑花	饮食/2烹饪/2中国烹饪/2八大菜系/川菜
金银蛋花	饮食/2烹饪/2中国烹饪/2八大菜系/川菜
锦绣时菜塔	饮食/2烹饪/2中国烹饪/2八大菜系/川菜
鸡丝米粉	饮食/2烹饪/2中国烹饪/2八大菜系/川菜
鸡包鱼翅	饮食/2烹饪/2中国烹饪/2八大菜系/川菜
鸡杂	饮食/2烹饪/2中国烹饪/2八大菜系/川菜
鸡汁虾卷	饮食/2烹饪/2中国烹饪/2八大菜系/川菜
鸡火冬瓜燕	饮食/2烹饪/2中国烹饪/2八大菜系/川菜
鸡肉滷味	饮食/2烹饪/2中国烹饪/2八大菜系/川菜
鸡肉甘蓝双拼	饮食/2烹饪/2中国烹饪/2八大菜系/川菜
鸡蓉鲍片	饮食/2烹饪/2中国烹饪/2八大菜系/川菜
鸡蛋花汤	饮食/2烹饪/2中国烹饪/2八大菜系/川菜
鸡豆花	饮食/2烹饪/2中国烹饪/2八大菜系/川菜
鸡蹄花	饮食/2烹饪/2中国烹饪/2八大菜系/川菜
吉庆奶汁鸡	饮食/2烹饪/2中国烹饪/2八大菜系/川菜
江湖菜	饮食/2烹饪/2中国烹饪/2八大菜系/川菜
尖椒兔	饮食/2烹饪/2中国烹饪/2八大菜系/川菜
经典川菜800例	饮食/2烹饪/2中国烹饪/2八大菜系/川菜
椒麻腰片	饮食/2烹饪/2中国烹饪/2八大菜系/川菜
酱蛤蜊	饮食/2烹饪/2中国烹饪/2八大菜系/川菜
家常肉丝千张	饮食/2烹饪/2中国烹饪/2八大菜系/川菜
椒油蘑菇	饮食/2烹饪/2中国烹饪/2八大菜系/川菜
鸡丝拌海蜇	饮食/2烹饪/2中国烹饪/2八大菜系/川菜
金螺展翅	饮食/2烹饪/2中国烹饪/2八大菜系/川菜
家常炒菜	饮食/2烹饪/2中国烹饪/2八大菜系/川菜
酱烧小黄鱼	饮食/2烹饪/2中国烹饪/2八大菜系/川菜
椒麻四件	饮食/2烹饪/2中国烹饪/2八大菜系/川菜
焦耳川式快餐	饮食/2烹饪/2中国烹饪/2八大菜系/川菜
口味龙虾仔	饮食/2烹饪/2中国烹饪/2八大菜系/川菜
口水直流三千尺	饮食/2烹饪/2中国烹饪/2八大菜系/川菜
口水鸡	饮食/2烹饪/2中国烹饪/2八大菜系/川菜
口蘑蒸鸡	饮食/2烹饪/2中国烹饪/2八大菜系/川菜
口袋豆腐	饮食/2烹饪/2中国烹饪/2八大菜系/川菜
开水白菜	饮食/2烹饪/2中国烹饪/2八大菜系/川菜
烤叫化鸡	饮食/2烹饪/2中国烹饪/2八大菜系/川菜
烤扁担肉	饮食/2烹饪/2中国烹饪/2八大菜系/川菜
苦瓜酿肉	饮食/2烹饪/2中国烹饪/2八大菜系/川菜
咖喱山药	饮食/2烹饪/2中国烹饪/2八大菜系/川菜
鲤跃龙门[菜品]	饮食/2烹饪/2中国烹饪/2八大菜系/川菜
冷啖杯	饮食/2烹饪/2中国烹饪/2八大菜系/川菜
凉粉烧排骨	饮食/2烹饪/2中国烹饪/2八大菜系/川菜
凉粉鲫鱼	饮食/2烹饪/2中国烹饪/2八大菜系/川菜
凉面饼子	饮食/2烹饪/2中国烹饪/2八大菜系/川菜
卤肉锅魁	饮食/2烹饪/2中国烹饪/2八大菜系/川菜
卤鸭肫	饮食/2烹饪/2中国烹饪/2八大菜系/川菜
廖记棒棒鸡	饮食/2烹饪/2中国烹饪/2八大菜系/川菜
恋爱豆腐	饮食/2烹饪/2中国烹饪/2八大菜系/川菜
李庄白肉	饮食/2烹饪/2中国烹饪/2八大菜系/川菜
栗子白菜	饮食/2烹饪/2中国烹饪/2八大菜系/川菜
栗杏焖鸡	饮食/2烹饪/2中国烹饪/2八大菜系/川菜
榄菜胡萝卜碎	饮食/2烹饪/2中国烹饪/2八大菜系/川菜
泸州鱼头火锅	饮食/2烹饪/2中国烹饪/2八大菜系/川菜
熘两色鸡米	饮食/2烹饪/2中国烹饪/2八大菜系/川菜
箩粉鱼头豆腐汤	饮食/2烹饪/2中国烹饪/2八大菜系/川菜
老房子元年食府	饮食/2烹饪/2中国烹饪/2八大菜系/川菜
老房子花园餐厅	饮食/2烹饪/2中国烹饪/2八大菜系/川菜
老房子靓家火锅	饮食/2烹饪/2中国烹饪/2八大菜系/川菜
老胡记棒棒鸡	饮食/2烹饪/2中国烹饪/2八大菜系/川菜
老醋蛰头	饮食/2烹饪/2中国烹饪/2八大菜系/川菜
腊肉	饮食/2烹饪/2中国烹饪/2八大菜系/川菜
芦笋牛肉	饮食/2烹饪/2中国烹饪/2八大菜系/川菜
荔枝锅巴肉片	饮食/2烹饪/2中国烹饪/2八大菜系/川菜
荔枝鱿鱼卷	饮食/2烹饪/2中国烹饪/2八大菜系/川菜
萝卜干炒鸡丝	饮食/2烹饪/2中国烹饪/2八大菜系/川菜
萝卜炖羊肉	饮食/2烹饪/2中国烹饪/2八大菜系/川菜
萝卜莲锅汤	饮食/2烹饪/2中国烹饪/2八大菜系/川菜
辣味炸鸡翅	饮食/2烹饪/2中国烹饪/2八大菜系/川菜
辣味煎烤羊肉	饮食/2烹饪/2中国烹饪/2八大菜系/川菜
辣味豆干韭菜花	饮食/2烹饪/2中国烹饪/2八大菜系/川菜
辣味过江鸡	饮食/2烹饪/2中国烹饪/2八大菜系/川菜
辣味金针菇	饮食/2烹饪/2中国烹饪/2八大菜系/川菜
辣子肥肠	饮食/2烹饪/2中国烹饪/2八大菜系/川菜
辣子脆肠	饮食/2烹饪/2中国烹饪/2八大菜系/川菜
辣子鸡	饮食/2烹饪/2中国烹饪/2八大菜系/川菜
辣子鸡丁	饮食/2烹饪/2中国烹饪/2八大菜系/川菜
辣子鸡丁烩饭	饮食/2烹饪/2中国烹饪/2八大菜系/川菜
辣椒泡鱼	饮食/2烹饪/2中国烹饪/2八大菜系/川菜
辣椒碎碎肉	饮食/2烹饪/2中国烹饪/2八大菜系/川菜
辣椒蟹	饮食/2烹饪/2中国烹饪/2八大菜系/川菜
辣汁卤排骨	饮食/2烹饪/2中国烹饪/2八大菜系/川菜
辣汁泥肠	饮食/2烹饪/2中国烹饪/2八大菜系/川菜
辣汁茄丝	饮食/2烹饪/2中国烹饪/2八大菜系/川菜
辣油里脊丝	饮食/2烹饪/2中国烹饪/2八大菜系/川菜
辣炒花蛤	饮食/2烹饪/2中国烹饪/2八大菜系/川菜
辣炒鱿鱼丝	饮食/2烹饪/2中国烹饪/2八大菜系/川菜
辣炸芋头片	饮食/2烹饪/2中国烹饪/2八大菜系/川菜
辣白菜	饮食/2烹饪/2中国烹饪/2八大菜系/川菜
辣豆瓣鱼	饮食/2烹饪/2中国烹饪/2八大菜系/川菜
辣香味鲜豆豉双椒鸡	饮食/2烹饪/2中国烹饪/2八大菜系/川菜
连理双味鱼	饮食/2烹饪/2中国烹饪/2八大菜系/川菜
连锅汤	饮食/2烹饪/2中国烹饪/2八大菜系/川菜
鹿茸牛肉卷	饮食/2烹饪/2中国烹饪/2八大菜系/川菜
黎家竹筒饭	饮食/2烹饪/2中国烹饪/2八大菜系/川菜
龙井鲍片	饮食/2烹饪/2中国烹饪/2八大菜系/川菜
龙井鲍鱼	饮食/2烹饪/2中国烹饪/2八大菜系/川菜
龙眼咸烧白	饮食/2烹饪/2中国烹饪/2八大菜系/川菜
龙眼烧白	饮食/2烹饪/2中国烹饪/2八大菜系/川菜
龙眼甜烧白	饮食/2烹饪/2中国烹饪/2八大菜系/川菜
辣炒牛河	饮食/2烹饪/2中国烹饪/2八大菜系/川菜
老房子民风酒楼	饮食/2烹饪/2中国烹饪/2八大菜系/川菜
龙眼苦瓜	饮食/2烹饪/2中国烹饪/2八大菜系/川菜
凉拌怪味鸡	饮食/2烹饪/2中国烹饪/2八大菜系/川菜
冷锅鱼	饮食/2烹饪/2中国烹饪/2八大菜系/川菜
辣子蒜香骨	饮食/2烹饪/2中国烹饪/2八大菜系/川菜
辣子爆肉	饮食/2烹饪/2中国烹饪/2八大菜系/川菜
辣子肉片	饮食/2烹饪/2中国烹饪/2八大菜系/川菜
萝卜丝炒牛肉丝	饮食/2烹饪/2中国烹饪/2八大菜系/川菜
卢朝华	饮食/2烹饪/2中国烹饪/2八大菜系/川菜
龙眼珊瑚鹿肉	饮食/2烹饪/2中国烹饪/2八大菜系/川菜
明炉三菌猪肝汤	饮食/2烹饪/2中国烹饪/2八大菜系/川菜
明炉鱼头肚片汤	饮食/2烹饪/2中国烹饪/2八大菜系/川菜
木瓜辽参	饮食/2烹饪/2中国烹饪/2八大菜系/川菜
毛肚火锅	饮食/2烹饪/2中国烹饪/2八大菜系/川菜
毛血旺	饮食/2烹饪/2中国烹饪/2八大菜系/川菜
满堂水煮鱼	饮食/2烹饪/2中国烹饪/2八大菜系/川菜
满庭芳酒楼	饮食/2烹饪/2中国烹饪/2八大菜系/川菜
玫瑰凉糍粑	饮食/2烹饪/2中国烹饪/2八大菜系/川菜
玫瑰锅炸	饮食/2烹饪/2中国烹饪/2八大菜系/川菜
米熏仔鸡	饮食/2烹饪/2中国烹饪/2八大菜系/川菜
米熏鱼	饮食/2烹饪/2中国烹饪/2八大菜系/川菜
美味佳肴	饮食/2烹饪/2中国烹饪/2八大菜系/川菜
美味豆腐汤	饮食/2烹饪/2中国烹饪/2八大菜系/川菜
蜜汁山药琢	饮食/2烹饪/2中国烹饪/2八大菜系/川菜
麻圆	饮食/2烹饪/2中国烹饪/2八大菜系/川菜
麻婆豆腐	饮食/2烹饪/2中国烹饪/2八大菜系/川菜
麻婆豆腐1	饮食/2烹饪/2中国烹饪/2八大菜系/川菜
麻婆豆腐鱼	饮食/2烹饪/2中国烹饪/2八大菜系/川菜
麻油火鸡肾	饮食/2烹饪/2中国烹饪/2八大菜系/川菜
麻油鸡	饮食/2烹饪/2中国烹饪/2八大菜系/川菜
麻辣冬瓜	饮食/2烹饪/2中国烹饪/2八大菜系/川菜
麻辣冻豆腐	饮食/2烹饪/2中国烹饪/2八大菜系/川菜
麻辣啤酒鸭	饮食/2烹饪/2中国烹饪/2八大菜系/川菜
麻辣干煸兔丁	饮食/2烹饪/2中国烹饪/2八大菜系/川菜
麻辣干锅面筋	饮食/2烹饪/2中国烹饪/2八大菜系/川菜
麻辣牛肉	饮食/2烹饪/2中国烹饪/2八大菜系/川菜
麻辣牛肉丝	饮食/2烹饪/2中国烹饪/2八大菜系/川菜
麻辣牛肉豆腐	饮食/2烹饪/2中国烹饪/2八大菜系/川菜
麻辣猪肉干	饮食/2烹饪/2中国烹饪/2八大菜系/川菜
麻辣猪肝	饮食/2烹饪/2中国烹饪/2八大菜系/川菜
麻辣田螺	饮食/2烹饪/2中国烹饪/2八大菜系/川菜
麻辣白菜	饮食/2烹饪/2中国烹饪/2八大菜系/川菜
麻辣红萝卜丝	饮食/2烹饪/2中国烹饪/2八大菜系/川菜
麻辣肉丁	饮食/2烹饪/2中国烹饪/2八大菜系/川菜
麻辣肉片	饮食/2烹饪/2中国烹饪/2八大菜系/川菜
麻辣诱惑蛙	饮食/2烹饪/2中国烹饪/2八大菜系/川菜
麻辣香水鱼	饮食/2烹饪/2中国烹饪/2八大菜系/川菜
麻辣鳝片	饮食/2烹饪/2中国烹饪/2八大菜系/川菜
麻辣鸡肫毛豆	饮食/2烹饪/2中国烹饪/2八大菜系/川菜
麻辣黄鳝	饮食/2烹饪/2中国烹饪/2八大菜系/川菜
麻酱凤尾	饮食/2烹饪/2中国烹饪/2八大菜系/川菜
麻酱笋尖	饮食/2烹饪/2中国烹饪/2八大菜系/川菜
麻酱腰片	饮食/2烹饪/2中国烹饪/2八大菜系/川菜
麻辣萝卜干	饮食/2烹饪/2中国烹饪/2八大菜系/川菜
麻辣花椒鸡	饮食/2烹饪/2中国烹饪/2八大菜系/川菜
麻辣鲨鱼肚	饮食/2烹饪/2中国烹饪/2八大菜系/川菜
麻辣蛋羹鱼	饮食/2烹饪/2中国烹饪/2八大菜系/川菜
蜜柚烧牛蛙	饮食/2烹饪/2中国烹饪/2八大菜系/川菜
明虾烧粉丝	饮食/2烹饪/2中国烹饪/2八大菜系/川菜
美味川菜	饮食/2烹饪/2中国烹饪/2八大菜系/川菜
农家绿豆花	饮食/2烹饪/2中国烹饪/2八大菜系/川菜
南乳排叉	饮食/2烹饪/2中国烹饪/2八大菜系/川菜
南乳脆香鸡	饮食/2烹饪/2中国烹饪/2八大菜系/川菜
南排杂烩	饮食/2烹饪/2中国烹饪/2八大菜系/川菜
南荠烧鸭丁	饮食/2烹饪/2中国烹饪/2八大菜系/川菜
柠檬黄瓜条	饮食/2烹饪/2中国烹饪/2八大菜系/川菜
牛佛烘肘	饮食/2烹饪/2中国烹饪/2八大菜系/川菜
牛肉馅饼	饮食/2烹饪/2中国烹饪/2八大菜系/川菜
牛肚火锅	饮食/2烹饪/2中国烹饪/2八大菜系/川菜
牛膝蹄筋	饮食/2烹饪/2中国烹饪/2八大菜系/川菜
牛蛙火锅	饮食/2烹饪/2中国烹饪/2八大菜系/川菜
酿青椒	饮食/2烹饪/2中国烹饪/2八大菜系/川菜
柠汁菠萝鱼	饮食/2烹饪/2中国烹饪/2八大菜系/川菜
南充冬菜	饮食/2烹饪/2中国烹饪/2八大菜系/川菜
南京老灶兴餐饮管理有	饮食/2烹饪/2中国烹饪/2八大菜系/川菜
平都牛肉松	饮食/2烹饪/2中国烹饪/2八大菜系/川菜
庖丁府盐边牛肉	饮食/2烹饪/2中国烹饪/2八大菜系/川菜
泡 菜 鱼	饮食/2烹饪/2中国烹饪/2八大菜系/川菜
泡五香黄瓜	饮食/2烹饪/2中国烹饪/2八大菜系/川菜
泡凤爪	饮食/2烹饪/2中国烹饪/2八大菜系/川菜
泡四季豆	饮食/2烹饪/2中国烹饪/2八大菜系/川菜
泡嫩姜	饮食/2烹饪/2中国烹饪/2八大菜系/川菜
泡子姜	饮食/2烹饪/2中国烹饪/2八大菜系/川菜
泡椒乳鸽	饮食/2烹饪/2中国烹饪/2八大菜系/川菜
泡椒墨鱼仔	饮食/2烹饪/2中国烹饪/2八大菜系/川菜
泡椒江团	饮食/2烹饪/2中国烹饪/2八大菜系/川菜
泡椒河鳗	饮食/2烹饪/2中国烹饪/2八大菜系/川菜
泡椒牛肉丝	饮食/2烹饪/2中国烹饪/2八大菜系/川菜
泡椒腰花	饮食/2烹饪/2中国烹饪/2八大菜系/川菜
泡椒蒸水鱼	饮食/2烹饪/2中国烹饪/2八大菜系/川菜
泡椒豆腐	饮食/2烹饪/2中国烹饪/2八大菜系/川菜
泡椒鸡杂	饮食/2烹饪/2中国烹饪/2八大菜系/川菜
泡椒鸡片	饮食/2烹饪/2中国烹饪/2八大菜系/川菜
泡椒黄辣丁	饮食/2烹饪/2中国烹饪/2八大菜系/川菜
泡粑	饮食/2烹饪/2中国烹饪/2八大菜系/川菜
泡莱鲫鱼	饮食/2烹饪/2中国烹饪/2八大菜系/川菜
泡菜炒肉末	饮食/2烹饪/2中国烹饪/2八大菜系/川菜
泡菜爆河虾	饮食/2烹饪/2中国烹饪/2八大菜系/川菜
泡菜肉末	饮食/2烹饪/2中国烹饪/2八大菜系/川菜
泡菜鱼	饮食/2烹饪/2中国烹饪/2八大菜系/川菜
泡菜鹅肠	饮食/2烹饪/2中国烹饪/2八大菜系/川菜
泡萝卜条	饮食/2烹饪/2中国烹饪/2八大菜系/川菜
泡辣椒	饮食/2烹饪/2中国烹饪/2八大菜系/川菜
泡酸辣萝卜	饮食/2烹饪/2中国烹饪/2八大菜系/川菜
浦江蟹羹	饮食/2烹饪/2中国烹饪/2八大菜系/川菜
牌坊面	饮食/2烹饪/2中国烹饪/2八大菜系/川菜
蒲江蟹羹	饮食/2烹饪/2中国烹饪/2八大菜系/川菜
飘香浮水鱼	饮食/2烹饪/2中国烹饪/2八大菜系/川菜
飘香猪脆骨	饮食/2烹饪/2中国烹饪/2八大菜系/川菜
泡椒姜爆鸡	饮食/2烹饪/2中国烹饪/2八大菜系/川菜
泡菜参蟹	饮食/2烹饪/2中国烹饪/2八大菜系/川菜
泡椒肉丝	饮食/2烹饪/2中国烹饪/2八大菜系/川菜
七星鱼丸汤	饮食/2烹饪/2中国烹饪/2八大菜系/川菜
乾坤蒸狗	饮食/2烹饪/2中国烹饪/2八大菜系/川菜
清水白菜	饮食/2烹饪/2中国烹饪/2八大菜系/川菜
清汤圆子	饮食/2烹饪/2中国烹饪/2八大菜系/川菜
清汤柳叶燕菜	饮食/2烹饪/2中国烹饪/2八大菜系/川菜
清汤燕菜	饮食/2烹饪/2中国烹饪/2八大菜系/川菜
清汤群蟹	饮食/2烹饪/2中国烹饪/2八大菜系/川菜
清汤鸡蒙冬菇	饮食/2烹饪/2中国烹饪/2八大菜系/川菜
清蒸江团	饮食/2烹饪/2中国烹饪/2八大菜系/川菜
清蒸甲鱼	饮食/2烹饪/2中国烹饪/2八大菜系/川菜
清蒸青鳝	饮食/2烹饪/2中国烹饪/2八大菜系/川菜
清蒸鸭子	饮食/2烹饪/2中国烹饪/2八大菜系/川菜
炝炒油菜苔	饮食/2烹饪/2中国烹饪/2八大菜系/川菜
炝莲白卷	饮食/2烹饪/2中国烹饪/2八大菜系/川菜
炝黄瓜	饮食/2烹饪/2中国烹饪/2八大菜系/川菜
炝黄瓜条	饮食/2烹饪/2中国烹饪/2八大菜系/川菜
秦妈老火锅	饮食/2烹饪/2中国烹饪/2八大菜系/川菜
芪烧活鱼	饮食/2烹饪/2中国烹饪/2八大菜系/川菜
芪蒸鹌鹑	饮食/2烹饪/2中国烹饪/2八大菜系/川菜
芹菜回锅肉	饮食/2烹饪/2中国烹饪/2八大菜系/川菜
芹菜红萝卜炒牛肉	饮食/2烹饪/2中国烹饪/2八大菜系/川菜
芹黄烧鱼条	饮食/2烹饪/2中国烹饪/2八大菜系/川菜
芹黄鱼丝	饮食/2烹饪/2中国烹饪/2八大菜系/川菜
茄汁鱼卷	饮食/2烹饪/2中国烹饪/2八大菜系/川菜
茄汤焗香鸡	饮食/2烹饪/2中国烹饪/2八大菜系/川菜
荞面拌拐肉	饮食/2烹饪/2中国烹饪/2八大菜系/川菜
青椒塞肉	饮食/2烹饪/2中国烹饪/2八大菜系/川菜
青椒牛肉丝	饮食/2烹饪/2中国烹饪/2八大菜系/川菜
青椒皮蛋	饮食/2烹饪/2中国烹饪/2八大菜系/川菜
青椒茄泥	饮食/2烹饪/2中国烹饪/2八大菜系/川菜
青菠面	饮食/2烹饪/2中国烹饪/2八大菜系/川菜
青蒜回锅肉	饮食/2烹饪/2中国烹饪/2八大菜系/川菜
青蟹溜黄蛋	饮食/2烹饪/2中国烹饪/2八大菜系/川菜
青城仙斋	饮食/2烹饪/2中国烹饪/2八大菜系/川菜
乔外婆	饮食/2烹饪/2中国烹饪/2八大菜系/川菜
茄汁龙虾球	饮食/2烹饪/2中国烹饪/2八大菜系/川菜
燃面	饮食/2烹饪/2中国烹饪/2八大菜系/川菜
瓤甜椒	饮食/2烹饪/2中国烹饪/2八大菜系/川菜
肉桂核桃酥	饮食/2烹饪/2中国烹饪/2八大菜系/川菜
蓉城鸳鸯卷	饮食/2烹饪/2中国烹饪/2八大菜系/川菜
软炸兔糕	饮食/2烹饪/2中国烹饪/2八大菜系/川菜
软炸虾糕	饮食/2烹饪/2中国烹饪/2八大菜系/川菜
软炸鸡肝	饮食/2烹饪/2中国烹饪/2八大菜系/川菜
软烧仔鲇	饮食/2烹饪/2中国烹饪/2八大菜系/川菜
软炸全蝎	饮食/2烹饪/2中国烹饪/2八大菜系/川菜
三丁野菜	饮食/2烹饪/2中国烹饪/2八大菜系/川菜
三七蒸鸡	饮食/2烹饪/2中国烹饪/2八大菜系/川菜
三丝鱼翅	饮食/2烹饪/2中国烹饪/2八大菜系/川菜
三味薏米羹	饮食/2烹饪/2中国烹饪/2八大菜系/川菜
三杯鸡	饮食/2烹饪/2中国烹饪/2八大菜系/川菜
三椒戏牛尾	饮食/2烹饪/2中国烹饪/2八大菜系/川菜
三菌炖鸡	饮食/2烹饪/2中国烹饪/2八大菜系/川菜
三鲜脱骨鱼	饮食/2烹饪/2中国烹饪/2八大菜系/川菜
三鲜锅粑	饮食/2烹饪/2中国烹饪/2八大菜系/川菜
十全乌鸡汤	饮食/2烹饪/2中国烹饪/2八大菜系/川菜
十全炆补汤	饮食/2烹饪/2中国烹饪/2八大菜系/川菜
双仁浮皮	饮食/2烹饪/2中国烹饪/2八大菜系/川菜
双味珍珠元子	饮食/2烹饪/2中国烹饪/2八大菜系/川菜
双味蹄筋	饮食/2烹饪/2中国烹饪/2八大菜系/川菜
双椒脆鱼片	饮食/2烹饪/2中国烹饪/2八大菜系/川菜
双色玫瑰鱼	饮食/2烹饪/2中国烹饪/2八大菜系/川菜
双色白菜	饮食/2烹饪/2中国烹饪/2八大菜系/川菜
四件焖冬笋	饮食/2烹饪/2中国烹饪/2八大菜系/川菜
四味鲍鱼	饮食/2烹饪/2中国烹饪/2八大菜系/川菜
四川冲菜	饮食/2烹饪/2中国烹饪/2八大菜系/川菜
四川凉拌麻辣鸡	饮食/2烹饪/2中国烹饪/2八大菜系/川菜
四川家常酸辣汤	饮食/2烹饪/2中国烹饪/2八大菜系/川菜
四川板鸭	饮食/2烹饪/2中国烹饪/2八大菜系/川菜
四川泡大蒜	饮食/2烹饪/2中国烹饪/2八大菜系/川菜
四川泡菜	饮食/2烹饪/2中国烹饪/2八大菜系/川菜
四川泡辣椒	饮食/2烹饪/2中国烹饪/2八大菜系/川菜
四川烧白	饮食/2烹饪/2中国烹饪/2八大菜系/川菜
四川腊肉	饮食/2烹饪/2中国烹饪/2八大菜系/川菜
四川风味土豆烧排骨	饮食/2烹饪/2中国烹饪/2八大菜系/川菜
山城小汤圆	饮食/2烹饪/2中国烹饪/2八大菜系/川菜
山城棒棒鸡	饮食/2烹饪/2中国烹饪/2八大菜系/川菜
山巴厨子	饮食/2烹饪/2中国烹饪/2八大菜系/川菜
手撕干鱼仔	饮食/2烹饪/2中国烹饪/2八大菜系/川菜
手撕牛肉	饮食/2烹饪/2中国烹饪/2八大菜系/川菜
水八块	饮食/2烹饪/2中国烹饪/2八大菜系/川菜
水晶南瓜	饮食/2烹饪/2中国烹饪/2八大菜系/川菜
水晶橘子	饮食/2烹饪/2中国烹饪/2八大菜系/川菜
水浒肉	饮食/2烹饪/2中国烹饪/2八大菜系/川菜
水煮凤片	饮食/2烹饪/2中国烹饪/2八大菜系/川菜
水煮牛肉	饮食/2烹饪/2中国烹饪/2八大菜系/川菜
水煮肉片	饮食/2烹饪/2中国烹饪/2八大菜系/川菜
水煮鲢鱼	饮食/2烹饪/2中国烹饪/2八大菜系/川菜
沙参心肺汤	饮食/2烹饪/2中国烹饪/2八大菜系/川菜
深圳市新相约宾馆	饮食/2烹饪/2中国烹饪/2八大菜系/川菜
烧鸡丁辣子	饮食/2烹饪/2中国烹饪/2八大菜系/川菜
烧麦穗乌鱼花	饮食/2烹饪/2中国烹饪/2八大菜系/川菜
狮子糕	饮食/2烹饪/2中国烹饪/2八大菜系/川菜
珊瑚雪花鸡	饮食/2烹饪/2中国烹饪/2八大菜系/川菜
生暴盐煎肉	饮食/2烹饪/2中国烹饪/2八大菜系/川菜
生炒蒜苔肉	饮食/2烹饪/2中国烹饪/2八大菜系/川菜
生烧筋尾舌	饮食/2烹饪/2中国烹饪/2八大菜系/川菜
生爆盐煎肉	饮食/2烹饪/2中国烹饪/2八大菜系/川菜
石斛华生米	饮食/2烹饪/2中国烹饪/2八大菜系/川菜
砂锅雅鱼	饮食/2烹饪/2中国烹饪/2八大菜系/川菜
砂锅鱿鱼	饮食/2烹饪/2中国烹饪/2八大菜系/川菜
碎末鸡丁	饮食/2烹饪/2中国烹饪/2八大菜系/川菜
碎米鸡丁	饮食/2烹饪/2中国烹饪/2八大菜系/川菜
碎米鸭舌	饮食/2烹饪/2中国烹饪/2八大菜系/川菜
碎肉酸豆角	饮食/2烹饪/2中国烹饪/2八大菜系/川菜
笋丝鱼香肉丝	饮食/2烹饪/2中国烹饪/2八大菜系/川菜
笋子牛腩煲	饮食/2烹饪/2中国烹饪/2八大菜系/川菜
绍子海参	饮食/2烹饪/2中国烹饪/2八大菜系/川菜
绍子烘蛋	饮食/2烹饪/2中国烹饪/2八大菜系/川菜
臊子豆花	饮食/2烹饪/2中国烹饪/2八大菜系/川菜
艄公号子鱼	饮食/2烹饪/2中国烹饪/2八大菜系/川菜
苏州市布衣寒舍餐饮管	饮食/2烹饪/2中国烹饪/2八大菜系/川菜
苕菜狮子头	饮食/2烹饪/2中国烹饪/2八大菜系/川菜
蒜泥白肉	饮食/2烹饪/2中国烹饪/2八大菜系/川菜
蒜蓉酸辣毛豆	饮食/2烹饪/2中国烹饪/2八大菜系/川菜
蒟蒻凉拌	饮食/2烹饪/2中国烹饪/2八大菜系/川菜
蜀霸虾戏蟹	饮食/2烹饪/2中国烹饪/2八大菜系/川菜
酥炸凤尾鱼	饮食/2烹饪/2中国烹饪/2八大菜系/川菜
酥炸芝麻鱼	饮食/2烹饪/2中国烹饪/2八大菜系/川菜
酥烤大方	饮食/2烹饪/2中国烹饪/2八大菜系/川菜
酥皮鸡饺	饮食/2烹饪/2中国烹饪/2八大菜系/川菜
酥皮龙虾	饮食/2烹饪/2中国烹饪/2八大菜系/川菜
酥盒回锅肉	饮食/2烹饪/2中国烹饪/2八大菜系/川菜
酥肉汤	饮食/2烹饪/2中国烹饪/2八大菜系/川菜
酸汤肥牛	饮食/2烹饪/2中国烹饪/2八大菜系/川菜
酸甜仔姜片	饮食/2烹饪/2中国烹饪/2八大菜系/川菜
酸菜火锅	饮食/2烹饪/2中国烹饪/2八大菜系/川菜
酸菜牛肉丸子	饮食/2烹饪/2中国烹饪/2八大菜系/川菜
酸菜鱼	饮食/2烹饪/2中国烹饪/2八大菜系/川菜
酸辣岩水豆花	饮食/2烹饪/2中国烹饪/2八大菜系/川菜
酸辣牛筋煲	饮食/2烹饪/2中国烹饪/2八大菜系/川菜
酸辣牛肉羹	饮食/2烹饪/2中国烹饪/2八大菜系/川菜
酸辣白菜	饮食/2烹饪/2中国烹饪/2八大菜系/川菜
酸辣臊子蹄筋	饮食/2烹饪/2中国烹饪/2八大菜系/川菜
酸辣蹄筋	饮食/2烹饪/2中国烹饪/2八大菜系/川菜
酸辣鱼	饮食/2烹饪/2中国烹饪/2八大菜系/川菜
酸辣鱿鱼丝	饮食/2烹饪/2中国烹饪/2八大菜系/川菜
酸辣鸭血旺	饮食/2烹饪/2中国烹饪/2八大菜系/川菜
首乌肝片	饮食/2烹饪/2中国烹饪/2八大菜系/川菜
鳝鱼鸡蛋卷	饮食/2烹饪/2中国烹饪/2八大菜系/川菜
双味鱼圆	饮食/2烹饪/2中国烹饪/2八大菜系/川菜
水煮干豆腐	饮食/2烹饪/2中国烹饪/2八大菜系/川菜
酸菜炖鲶鱼	饮食/2烹饪/2中国烹饪/2八大菜系/川菜
臊子烘蛋	饮食/2烹饪/2中国烹饪/2八大菜系/川菜
四味清蒸龙虾	饮食/2烹饪/2中国烹饪/2八大菜系/川菜
三椒炒螺片	饮食/2烹饪/2中国烹饪/2八大菜系/川菜
蒜汁时蔬	饮食/2烹饪/2中国烹饪/2八大菜系/川菜
蒜苗炒肉	饮食/2烹饪/2中国烹饪/2八大菜系/川菜
四川凉粉	饮食/2烹饪/2中国烹饪/2八大菜系/川菜
双椒鸡丁	饮食/2烹饪/2中国烹饪/2八大菜系/川菜
酸辣鸡血	饮食/2烹饪/2中国烹饪/2八大菜系/川菜
酥炸鸭片	饮食/2烹饪/2中国烹饪/2八大菜系/川菜
坛子肉	饮食/2烹饪/2中国烹饪/2八大菜系/川菜
太极双丝	饮食/2烹饪/2中国烹饪/2八大菜系/川菜
太极双泥	饮食/2烹饪/2中国烹饪/2八大菜系/川菜
太白鸭	饮食/2烹饪/2中国烹饪/2八大菜系/川菜
太白鸭子	饮食/2烹饪/2中国烹饪/2八大菜系/川菜
提丝发糕	饮食/2烹饪/2中国烹饪/2八大菜系/川菜
桃杞鸡卷	饮食/2烹饪/2中国烹饪/2八大菜系/川菜
桃米炒蛋	饮食/2烹饪/2中国烹饪/2八大菜系/川菜
桃酥鸡糕	饮食/2烹饪/2中国烹饪/2八大菜系/川菜
氽鸡卷	饮食/2烹饪/2中国烹饪/2八大菜系/川菜
潼川豆豉	饮食/2烹饪/2中国烹饪/2八大菜系/川菜
烫面油糕	饮食/2烹饪/2中国烹饪/2八大菜系/川菜
甜椒肉丝	饮食/2烹饪/2中国烹饪/2八大菜系/川菜
甜烧白	饮食/2烹饪/2中国烹饪/2八大菜系/川菜
甜艾团	饮食/2烹饪/2中国烹饪/2八大菜系/川菜
甜辣回锅肉	饮食/2烹饪/2中国烹饪/2八大菜系/川菜
砣砣鸡肉	饮食/2烹饪/2中国烹饪/2八大菜系/川菜
糖汁烧茄子	饮食/2烹饪/2中国烹饪/2八大菜系/川菜
糖粘羊尾	饮食/2烹饪/2中国烹饪/2八大菜系/川菜
糖醋泡菜	饮食/2烹饪/2中国烹饪/2八大菜系/川菜
糖醋红柿椒	饮食/2烹饪/2中国烹饪/2八大菜系/川菜
糖醋脆皮鱼	饮食/2烹饪/2中国烹饪/2八大菜系/川菜
糖醋鸡圆	饮食/2烹饪/2中国烹饪/2八大菜系/川菜
乌发汤	饮食/2烹饪/2中国烹饪/2八大菜系/川菜
五味明虾片	饮食/2烹饪/2中国烹饪/2八大菜系/川菜
五宝砂锅	饮食/2烹饪/2中国烹饪/2八大菜系/川菜
五彩蟹盒	饮食/2烹饪/2中国烹饪/2八大菜系/川菜
五更肠旺	饮食/2烹饪/2中国烹饪/2八大菜系/川菜
五柳鱼丝	饮食/2烹饪/2中国烹饪/2八大菜系/川菜
五柳鲜鱼	饮食/2烹饪/2中国烹饪/2八大菜系/川菜
五柳黄花鱼	饮食/2烹饪/2中国烹饪/2八大菜系/川菜
五花回锅肉	饮食/2烹饪/2中国烹饪/2八大菜系/川菜
五花肉炒豆腐泡菜	饮食/2烹饪/2中国烹饪/2八大菜系/川菜
五通桥月糕	饮食/2烹饪/2中国烹饪/2八大菜系/川菜
五香熏鱼	饮食/2烹饪/2中国烹饪/2八大菜系/川菜
五香脆皮鸡	饮食/2烹饪/2中国烹饪/2八大菜系/川菜
围炉火锅	饮食/2烹饪/2中国烹饪/2八大菜系/川菜
网油包烧鸡	饮食/2烹饪/2中国烹饪/2八大菜系/川菜
网油腰卷	饮食/2烹饪/2中国烹饪/2八大菜系/川菜
网油鱼包	饮食/2烹饪/2中国烹饪/2八大菜系/川菜
芜爆里脊	饮食/2烹饪/2中国烹饪/2八大菜系/川菜
五彩白肉卷	饮食/2烹饪/2中国烹饪/2八大菜系/川菜
瓦块鸡	饮食/2烹饪/2中国烹饪/2八大菜系/川菜
五花肉回锅	饮食/2烹饪/2中国烹饪/2八大菜系/川菜
咸烧白	饮食/2烹饪/2中国烹饪/2八大菜系/川菜
响铃海参	饮食/2烹饪/2中国烹饪/2八大菜系/川菜
喜沙肉	饮食/2烹饪/2中国烹饪/2八大菜系/川菜
学做川菜	饮食/2烹饪/2中国烹饪/2八大菜系/川菜
小煎鸡	饮食/2烹饪/2中国烹饪/2八大菜系/川菜
小笼粉蒸牛肉	饮食/2烹饪/2中国烹饪/2八大菜系/川菜
小葱烧财鱼	饮食/2烹饪/2中国烹饪/2八大菜系/川菜
新都桂花糕	饮食/2烹饪/2中国烹饪/2八大菜系/川菜
杏仁松果鸡	饮食/2烹饪/2中国烹饪/2八大菜系/川菜
杏仁豆腐	饮食/2烹饪/2中国烹饪/2八大菜系/川菜
杏仁银肺汤	饮食/2烹饪/2中国烹饪/2八大菜系/川菜
湘粤凉拌土豆丝	饮食/2烹饪/2中国烹饪/2八大菜系/川菜
熊掌豆腐	饮食/2烹饪/2中国烹饪/2八大菜系/川菜
玄宗鹿肾长龟汤	饮食/2烹饪/2中国烹饪/2八大菜系/川菜
箱包豆腐	饮食/2烹饪/2中国烹饪/2八大菜系/川菜
细说川菜六种辣	饮食/2烹饪/2中国烹饪/2八大菜系/川菜
绣球鱼翅	饮食/2烹饪/2中国烹饪/2八大菜系/川菜
虾仁冬瓜汤	饮食/2烹饪/2中国烹饪/2八大菜系/川菜
虾肉粉果	饮食/2烹饪/2中国烹饪/2八大菜系/川菜
虾须牛肉	饮食/2烹饪/2中国烹饪/2八大菜系/川菜
西芹百合草莓炒腊肉	饮食/2烹饪/2中国烹饪/2八大菜系/川菜
辛香汇	饮食/2烹饪/2中国烹饪/2八大菜系/川菜
镶碗	饮食/2烹饪/2中国烹饪/2八大菜系/川菜
雪花鸡汤	饮食/2烹饪/2中国烹饪/2八大菜系/川菜
雪花鸡淖	饮食/2烹饪/2中国烹饪/2八大菜系/川菜
雪花鸡焯	饮食/2烹饪/2中国烹饪/2八大菜系/川菜
雪菜捆三辣	饮食/2烹饪/2中国烹饪/2八大菜系/川菜
雪魔芋鸡翅	饮食/2烹饪/2中国烹饪/2八大菜系/川菜
香卤豆干茄脯	饮食/2烹饪/2中国烹饪/2八大菜系/川菜
香干回锅肉	饮食/2烹饪/2中国烹饪/2八大菜系/川菜
香干炒白菜丝	饮食/2烹饪/2中国烹饪/2八大菜系/川菜
香椿白肉丝	饮食/2烹饪/2中国烹饪/2八大菜系/川菜
香油米花糖	饮食/2烹饪/2中国烹饪/2八大菜系/川菜
香炸麻辣牛排	饮食/2烹饪/2中国烹饪/2八大菜系/川菜
香煎韭菜盒	饮食/2烹饪/2中国烹饪/2八大菜系/川菜
香爆盐煎肉	饮食/2烹饪/2中国烹饪/2八大菜系/川菜
香瓜鸡盅	饮食/2烹饪/2中国烹饪/2八大菜系/川菜
香肠油菜	饮食/2烹饪/2中国烹饪/2八大菜系/川菜
香脆三丝	饮食/2烹饪/2中国烹饪/2八大菜系/川菜
香葱炒豌豆	饮食/2烹饪/2中国烹饪/2八大菜系/川菜
香蒜咖喱炒蟹	饮食/2烹饪/2中国烹饪/2八大菜系/川菜
香辣三丝	饮食/2烹饪/2中国烹饪/2八大菜系/川菜
香辣乡村小炒鸡	饮食/2烹饪/2中国烹饪/2八大菜系/川菜
香辣毛豆	饮食/2烹饪/2中国烹饪/2八大菜系/川菜
香辣滷鸡心	饮食/2烹饪/2中国烹饪/2八大菜系/川菜
香辣炒牛蛙	饮食/2烹饪/2中国烹饪/2八大菜系/川菜
香辣炒蟹	饮食/2烹饪/2中国烹饪/2八大菜系/川菜
香辣牛肉条	饮食/2烹饪/2中国烹饪/2八大菜系/川菜
香辣盆盆虾	饮食/2烹饪/2中国烹饪/2八大菜系/川菜
香辣粉蒸肉	饮食/2烹饪/2中国烹饪/2八大菜系/川菜
香辣虾	饮食/2烹饪/2中国烹饪/2八大菜系/川菜
香辣蹄花	饮食/2烹饪/2中国烹饪/2八大菜系/川菜
香辣鲫鱼	饮食/2烹饪/2中国烹饪/2八大菜系/川菜
香辣黑豆芽	饮食/2烹饪/2中国烹饪/2八大菜系/川菜
香酥山药	饮食/2烹饪/2中国烹饪/2八大菜系/川菜
香酥竹荪鱼	饮食/2烹饪/2中国烹饪/2八大菜系/川菜
香酥蛇段	饮食/2烹饪/2中国烹饪/2八大菜系/川菜
香酥鸭	饮食/2烹饪/2中国烹饪/2八大菜系/川菜
鲜椒嫩仔鸡	饮食/2烹饪/2中国烹饪/2八大菜系/川菜
鲜炒鱼片	饮食/2烹饪/2中国烹饪/2八大菜系/川菜
鲜花白玉鸡片	饮食/2烹饪/2中国烹饪/2八大菜系/川菜
鲜花豆腐	饮食/2烹饪/2中国烹饪/2八大菜系/川菜
鲜贝鸡卷	饮食/2烹饪/2中国烹饪/2八大菜系/川菜
肖见明	饮食/2烹饪/2中国烹饪/2八大菜系/川菜
血燕烩龙虾	饮食/2烹饪/2中国烹饪/2八大菜系/川菜
蟹黄柿子虾	饮食/2烹饪/2中国烹饪/2八大菜系/川菜
香荽牛肉丝	饮食/2烹饪/2中国烹饪/2八大菜系/川菜
犀浦酱油	饮食/2烹饪/2中国烹饪/2八大菜系/川菜
香煎鱼	饮食/2烹饪/2中国烹饪/2八大菜系/川菜
鲜椒鲈鱼	饮食/2烹饪/2中国烹饪/2八大菜系/川菜
香辣河虾	饮食/2烹饪/2中国烹饪/2八大菜系/川菜
一品海参	饮食/2烹饪/2中国烹饪/2八大菜系/川菜
一品熊掌	饮食/2烹饪/2中国烹饪/2八大菜系/川菜
一品豆腐汤	饮食/2烹饪/2中国烹饪/2八大菜系/川菜
一品配方	饮食/2烹饪/2中国烹饪/2八大菜系/川菜
一品酥方	饮食/2烹饪/2中国烹饪/2八大菜系/川菜
一品香辣虾	饮食/2烹饪/2中国烹饪/2八大菜系/川菜
一锅香干锅鸭头火锅	饮食/2烹饪/2中国烹饪/2八大菜系/川菜
云尖爆牛柳	饮食/2烹饪/2中国烹饪/2八大菜系/川菜
云片肝糕汤	饮食/2烹饪/2中国烹饪/2八大菜系/川菜
云长玉浆饺	饮食/2烹饪/2中国烹饪/2八大菜系/川菜
盐帮香辣虾	饮食/2烹饪/2中国烹饪/2八大菜系/川菜
原笼牛肉	饮食/2烹饪/2中国烹饪/2八大菜系/川菜
原笼玉簪	饮食/2烹饪/2中国烹饪/2八大菜系/川菜
原笼粉蒸	饮食/2烹饪/2中国烹饪/2八大菜系/川菜
原笼粉蒸肉	饮食/2烹饪/2中国烹饪/2八大菜系/川菜
宜宾肺片	饮食/2烹饪/2中国烹饪/2八大菜系/川菜
月母子鸡	饮食/2烹饪/2中国烹饪/2八大菜系/川菜
椰蓉挞	饮食/2烹饪/2中国烹饪/2八大菜系/川菜
油吃麻辣茭白	饮食/2烹饪/2中国烹饪/2八大菜系/川菜
油旋子锅魁	饮食/2烹饪/2中国烹饪/2八大菜系/川菜
油浸腰花	饮食/2烹饪/2中国烹饪/2八大菜系/川菜
油淋笋鸡	饮食/2烹饪/2中国烹饪/2八大菜系/川菜
油渣莲白	饮食/2烹饪/2中国烹饪/2八大菜系/川菜
油炸麻雀	饮食/2烹饪/2中国烹饪/2八大菜系/川菜
油闷辣味虾	饮食/2烹饪/2中国烹饪/2八大菜系/川菜
渔溪鲇鱼	饮食/2烹饪/2中国烹饪/2八大菜系/川菜
烟熏排骨	饮食/2烹饪/2中国烹饪/2八大菜系/川菜
牙牙饭	饮食/2烹饪/2中国烹饪/2八大菜系/川菜
玉竹心子	饮食/2烹饪/2中国烹饪/2八大菜系/川菜
盐水肫花	饮食/2烹饪/2中国烹饪/2八大菜系/川菜
盐煎肉	饮食/2烹饪/2中国烹饪/2八大菜系/川菜
盐菜回锅肉	饮食/2烹饪/2中国烹饪/2八大菜系/川菜
羊耳鸡塔	饮食/2烹饪/2中国烹饪/2八大菜系/川菜
羊肉汤锅	饮食/2烹饪/2中国烹饪/2八大菜系/川菜
羊肉酸菜汤	饮食/2烹饪/2中国烹饪/2八大菜系/川菜
腰果虾球	饮食/2烹饪/2中国烹饪/2八大菜系/川菜
芽菜	饮食/2烹饪/2中国烹饪/2八大菜系/川菜
野生菌汤	饮食/2烹饪/2中国烹饪/2八大菜系/川菜
野菌红烧肉	饮食/2烹饪/2中国烹饪/2八大菜系/川菜
野菜烩高蟹	饮食/2烹饪/2中国烹饪/2八大菜系/川菜
野鸡红炒牛肉丝	饮食/2烹饪/2中国烹饪/2八大菜系/川菜
银丝圆	饮食/2烹饪/2中国烹饪/2八大菜系/川菜
银杏蒸鸭	饮食/2烹饪/2中国烹饪/2八大菜系/川菜
玉米嫩兔	饮食/2烹饪/2中国烹饪/2八大菜系/川菜
鱼香味	饮食/2烹饪/2中国烹饪/2八大菜系/川菜
鱼香大虾	饮食/2烹饪/2中国烹饪/2八大菜系/川菜
鱼香油菜苔	饮食/2烹饪/2中国烹饪/2八大菜系/川菜
鱼香牛肉丝	饮食/2烹饪/2中国烹饪/2八大菜系/川菜
鱼香牛腩	饮食/2烹饪/2中国烹饪/2八大菜系/川菜
鱼香猪干	饮食/2烹饪/2中国烹饪/2八大菜系/川菜
鱼香猪肝	饮食/2烹饪/2中国烹饪/2八大菜系/川菜
鱼香白菜卷	饮食/2烹饪/2中国烹饪/2八大菜系/川菜
鱼香碎滑肉	饮食/2烹饪/2中国烹饪/2八大菜系/川菜
鱼香碎滑鸡	饮食/2烹饪/2中国烹饪/2八大菜系/川菜
鱼香紫茄子	饮食/2烹饪/2中国烹饪/2八大菜系/川菜
鱼香肉丝	饮食/2烹饪/2中国烹饪/2八大菜系/川菜
鱼香肉片	饮食/2烹饪/2中国烹饪/2八大菜系/川菜
鱼香脆皮茄子	饮食/2烹饪/2中国烹饪/2八大菜系/川菜
鱼香腰花	饮食/2烹饪/2中国烹饪/2八大菜系/川菜
鱼香芷排	饮食/2烹饪/2中国烹饪/2八大菜系/川菜
鱼香茄子	饮食/2烹饪/2中国烹饪/2八大菜系/川菜
鱼香茄饼	饮食/2烹饪/2中国烹饪/2八大菜系/川菜
鱼香荷包蛋	饮食/2烹饪/2中国烹饪/2八大菜系/川菜
鱼香酥青豆	饮食/2烹饪/2中国烹饪/2八大菜系/川菜
鱿鱼三鲜	饮食/2烹饪/2中国烹饪/2八大菜系/川菜
鸭掌包	饮食/2烹饪/2中国烹饪/2八大菜系/川菜
鹰扬虎视	饮食/2烹饪/2中国烹饪/2八大菜系/川菜
叶儿蒸牛蛙	饮食/2烹饪/2中国烹饪/2八大菜系/川菜
粤式鱼香茄子	饮食/2烹饪/2中国烹饪/2八大菜系/川菜
鱼香滑肉	饮食/2烹饪/2中国烹饪/2八大菜系/川菜
芋泥派	饮食/2烹饪/2中国烹饪/2八大菜系/川菜
银丝顺风虾	饮食/2烹饪/2中国烹饪/2八大菜系/川菜
鱼香虾球	饮食/2烹饪/2中国烹饪/2八大菜系/川菜
中江挂面	饮食/2烹饪/2中国烹饪/2八大菜系/川菜
主席红烧肉	饮食/2烹饪/2中国烹饪/2八大菜系/川菜
仲景羊肉汤	饮食/2烹饪/2中国烹饪/2八大菜系/川菜
蒸牛肉	饮食/2烹饪/2中国烹饪/2八大菜系/川菜
子姜鸭	饮食/2烹饪/2中国烹饪/2八大菜系/川菜
张凉粉水饺店	饮食/2烹饪/2中国烹饪/2八大菜系/川菜
折耳根炒腊肉	饮食/2烹饪/2中国烹饪/2八大菜系/川菜
杂炒田鸡	饮食/2烹饪/2中国烹饪/2八大菜系/川菜
梓潼片粉	饮食/2烹饪/2中国烹饪/2八大菜系/川菜
梓潼酥饼	饮食/2烹饪/2中国烹饪/2八大菜系/川菜
樟茶鸡	饮食/2烹饪/2中国烹饪/2八大菜系/川菜
樟茶鸭	饮食/2烹饪/2中国烹饪/2八大菜系/川菜
樟茶鸭子	饮食/2烹饪/2中国烹饪/2八大菜系/川菜
正宗重庆辣子鸡	饮食/2烹饪/2中国烹饪/2八大菜系/川菜
正宗鱼香茄子	饮食/2烹饪/2中国烹饪/2八大菜系/川菜
炸卷筒鸡	饮食/2烹饪/2中国烹饪/2八大菜系/川菜
炸珍珠虾	饮食/2烹饪/2中国烹饪/2八大菜系/川菜
炸班指	饮食/2烹饪/2中国烹饪/2八大菜系/川菜
炸花仁腰块	饮食/2烹饪/2中国烹饪/2八大菜系/川菜
炸花生仁腰块	饮食/2烹饪/2中国烹饪/2八大菜系/川菜
炸蒸肉	饮食/2烹饪/2中国烹饪/2八大菜系/川菜
状元卤味	饮食/2烹饪/2中国烹饪/2八大菜系/川菜
珍珠元子	饮食/2烹饪/2中国烹饪/2八大菜系/川菜
珍珠圆子	饮食/2烹饪/2中国烹饪/2八大菜系/川菜
珍珠粉耙	饮食/2烹饪/2中国烹饪/2八大菜系/川菜
珍珠酥皮鸡	饮食/2烹饪/2中国烹饪/2八大菜系/川菜
竹叶粉蒸果	饮食/2烹饪/2中国烹饪/2八大菜系/川菜
竹笋香菇汤	饮食/2烹饪/2中国烹饪/2八大菜系/川菜
竹荪肝膏汤	饮食/2烹饪/2中国烹饪/2八大菜系/川菜
竹荪蛋蒸乳鸽	饮食/2烹饪/2中国烹饪/2八大菜系/川菜
糟豆腐	饮食/2烹饪/2中国烹饪/2八大菜系/川菜
自贡水煮牛肉	饮食/2烹饪/2中国烹饪/2八大菜系/川菜
芝麻兔	饮食/2烹饪/2中国烹饪/2八大菜系/川菜
芝麻肉丝	饮食/2烹饪/2中国烹饪/2八大菜系/川菜
芝麻鹅脯	饮食/2烹饪/2中国烹饪/2八大菜系/川菜
蒸江团	饮食/2烹饪/2中国烹饪/2八大菜系/川菜
蘸水兔	饮食/2烹饪/2中国烹饪/2八大菜系/川菜
诸葛烤鱼	饮食/2烹饪/2中国烹饪/2八大菜系/川菜
重庆毛血旺	饮食/2烹饪/2中国烹饪/2八大菜系/川菜
重庆芋儿烧鸡	饮食/2烹饪/2中国烹饪/2八大菜系/川菜
重庆荤豆花	饮食/2烹饪/2中国烹饪/2八大菜系/川菜
自贡小煎鸭胗	饮食/2烹饪/2中国烹饪/2八大菜系/川菜
炸鳕鱼排	饮食/2烹饪/2中国烹饪/2八大菜系/川菜
仔姜雪魔芋	饮食/2烹饪/2中国烹饪/2八大菜系/川菜
重庆老麻抄手	饮食/2烹饪/2中国烹饪/2八大菜系/川菜
张串串	饮食/2烹饪/2中国烹饪/2八大菜系/川菜
扒翠珠活鲍	饮食/2烹饪/2中国烹饪/2八大菜系/2鲁菜/鲁菜菜系
菠萝荔枝炒蟹	饮食/2烹饪/2中国烹饪/2八大菜系/2鲁菜/鲁菜菜系
脆炸里脊卷	饮食/2烹饪/2中国烹饪/2八大菜系/2鲁菜/鲁菜菜系
葱扒海参	饮食/2烹饪/2中国烹饪/2八大菜系/2鲁菜/鲁菜菜系
干蹦鸡	饮食/2烹饪/2中国烹饪/2八大菜系/2鲁菜/鲁菜菜系
火夹槽青鱼	饮食/2烹饪/2中国烹饪/2八大菜系/2鲁菜/鲁菜菜系
焦熘丸子	饮食/2烹饪/2中国烹饪/2八大菜系/2鲁菜/鲁菜菜系
李神仙烤兔	饮食/2烹饪/2中国烹饪/2八大菜系/2鲁菜/鲁菜菜系
萝卜丝炖活	饮食/2烹饪/2中国烹饪/2八大菜系/2鲁菜/鲁菜菜系
辣炒蛏子	饮食/2烹饪/2中国烹饪/2八大菜系/2鲁菜/鲁菜菜系
浓汁活鲍鱼	饮食/2烹饪/2中国烹饪/2八大菜系/2鲁菜/鲁菜菜系
清氽蛎子	饮食/2烹饪/2中国烹饪/2八大菜系/2鲁菜/鲁菜菜系
瓤蜜浸枇杷	饮食/2烹饪/2中国烹饪/2八大菜系/2鲁菜/鲁菜菜系
水焖鸡蛋	饮食/2烹饪/2中国烹饪/2八大菜系/2鲁菜/鲁菜菜系
山珍长寿锅	饮食/2烹饪/2中国烹饪/2八大菜系/2鲁菜/鲁菜菜系
拖蒸偏口鱼	饮食/2烹饪/2中国烹饪/2八大菜系/2鲁菜/鲁菜菜系
氽鲜贝丸子	饮食/2烹饪/2中国烹饪/2八大菜系/2鲁菜/鲁菜菜系
糖醋活海参	饮食/2烹饪/2中国烹饪/2八大菜系/2鲁菜/鲁菜菜系
糖醋虾丸	饮食/2烹饪/2中国烹饪/2八大菜系/2鲁菜/鲁菜菜系
五香熏驴肉	饮食/2烹饪/2中国烹饪/2八大菜系/2鲁菜/鲁菜菜系
我爱美食网	饮食/2烹饪/2中国烹饪/2八大菜系/2鲁菜/鲁菜菜系
雪花核桃泥	饮食/2烹饪/2中国烹饪/2八大菜系/2鲁菜/鲁菜菜系
香菜拌海蛏	饮食/2烹饪/2中国烹饪/2八大菜系/2鲁菜/鲁菜菜系
香酥狗肉	饮食/2烹饪/2中国烹饪/2八大菜系/2鲁菜/鲁菜菜系
油泼原壳螺	饮食/2烹饪/2中国烹饪/2八大菜系/2鲁菜/鲁菜菜系
炸虾酱猪排	饮食/2烹饪/2中国烹饪/2八大菜系/2鲁菜/鲁菜菜系
《百年好合》	饮食/2烹饪/2中国烹饪/2八大菜系/粤菜
八味鸡	饮食/2烹饪/2中国烹饪/2八大菜系/粤菜
八宝姜米鸭	饮食/2烹饪/2中国烹饪/2八大菜系/粤菜
八宝扣鸭	饮食/2烹饪/2中国烹饪/2八大菜系/粤菜
八宝甜饭	饮食/2烹饪/2中国烹饪/2八大菜系/粤菜
八宝素菜	饮食/2烹饪/2中国烹饪/2八大菜系/粤菜
八宝蒸乌鸡	饮食/2烹饪/2中国烹饪/2八大菜系/粤菜
八宝辣酱	饮食/2烹饪/2中国烹饪/2八大菜系/粤菜
八宝金瓜盅	饮食/2烹饪/2中国烹饪/2八大菜系/粤菜
冰拌方鱼	饮食/2烹饪/2中国烹饪/2八大菜系/粤菜
冰梅子姜炆鸡翼	饮食/2烹饪/2中国烹饪/2八大菜系/粤菜
冰梅鸭	饮食/2烹饪/2中国烹饪/2八大菜系/粤菜
冰浸芥兰	饮食/2烹饪/2中国烹饪/2八大菜系/粤菜
冰皮盐水鸡	饮食/2烹饪/2中国烹饪/2八大菜系/粤菜
冰糖炖猪蹄	饮食/2烹饪/2中国烹饪/2八大菜系/粤菜
冰糖炖雪蛤	饮食/2烹饪/2中国烹饪/2八大菜系/粤菜
冰糖红枣炖银耳	饮食/2烹饪/2中国烹饪/2八大菜系/粤菜
冰糖鱼鳃	饮食/2烹饪/2中国烹饪/2八大菜系/粤菜
冰蜜金瓜	饮食/2烹饪/2中国烹饪/2八大菜系/粤菜
北杏参地老鸭汤	饮食/2烹饪/2中国烹饪/2八大菜系/粤菜
北芪南蛇汤	饮食/2烹饪/2中国烹饪/2八大菜系/粤菜
北芪炖乳鸽	饮食/2烹饪/2中国烹饪/2八大菜系/粤菜
北芪瘦肉	饮食/2烹饪/2中国烹饪/2八大菜系/粤菜
北芪莲子乳鸽汤	饮食/2烹饪/2中国烹饪/2八大菜系/粤菜
北芪黑豆泥鳅汤	饮食/2烹饪/2中国烹饪/2八大菜系/粤菜
北苠红枣泥鳅鱼汤	饮食/2烹饪/2中国烹饪/2八大菜系/粤菜
北菇扒双蔬	饮食/2烹饪/2中国烹饪/2八大菜系/粤菜
北菰火腿炆大芥菜	饮食/2烹饪/2中国烹饪/2八大菜系/粤菜
北菰炆海参	饮食/2烹饪/2中国烹饪/2八大菜系/粤菜
北菰鹅掌	饮食/2烹饪/2中国烹饪/2八大菜系/粤菜
北葱焖羊肉	饮食/2烹饪/2中国烹饪/2八大菜系/粤菜
半煎煮金龙鱼	饮食/2烹饪/2中国烹饪/2八大菜系/粤菜
半煎煮银鱼	饮食/2烹饪/2中国烹饪/2八大菜系/粤菜
半煎煮鱼	饮食/2烹饪/2中国烹饪/2八大菜系/粤菜
崩大碗煲猪展	饮食/2烹饪/2中国烹饪/2八大菜系/粤菜
扁尖笋虾米煮冬瓜	饮食/2烹饪/2中国烹饪/2八大菜系/粤菜
扁豆止带煎	饮食/2烹饪/2中国烹饪/2八大菜系/粤菜
扁豆薏米炖鸡脚	饮食/2烹饪/2中国烹饪/2八大菜系/粤菜
扒南瓜	饮食/2烹饪/2中国烹饪/2八大菜系/粤菜
扒素子双菇	饮食/2烹饪/2中国烹饪/2八大菜系/粤菜
板栗冰糖粥	饮食/2烹饪/2中国烹饪/2八大菜系/粤菜
板栗焖仔鸡	饮食/2烹饪/2中国烹饪/2八大菜系/粤菜
板栗煲老鸡	饮食/2烹饪/2中国烹饪/2八大菜系/粤菜
煲仔鱼丸	饮食/2烹饪/2中国烹饪/2八大菜系/粤菜
爆人参鸡片	饮食/2烹饪/2中国烹饪/2八大菜系/粤菜
玻璃白菜	饮食/2烹饪/2中国烹饪/2八大菜系/粤菜
玻璃肉饭	饮食/2烹饪/2中国烹饪/2八大菜系/粤菜
玻璃芋泥	饮食/2烹饪/2中国烹饪/2八大菜系/粤菜
玻璃芋蓉	饮食/2烹饪/2中国烹饪/2八大菜系/粤菜
玻璃酥鸡	饮食/2烹饪/2中国烹饪/2八大菜系/粤菜
玻璃酥鸭	饮食/2烹饪/2中国烹饪/2八大菜系/粤菜
玻璃龙虾筒	饮食/2烹饪/2中国烹饪/2八大菜系/粤菜
白云猪手	饮食/2烹饪/2中国烹饪/2八大菜系/粤菜
白云猪手(猪蹄)	饮食/2烹饪/2中国烹饪/2八大菜系/粤菜
白兰地茄汁冻蚝	饮食/2烹饪/2中国烹饪/2八大菜系/粤菜
白切鸡	饮食/2烹饪/2中国烹饪/2八大菜系/粤菜
白切鸡丝	饮食/2烹饪/2中国烹饪/2八大菜系/粤菜
白扒鱼唇	饮食/2烹饪/2中国烹饪/2八大菜系/粤菜
白斩河田鸡	饮食/2烹饪/2中国烹饪/2八大菜系/粤菜
白斩鸡	饮食/2烹饪/2中国烹饪/2八大菜系/粤菜
白木耳红枣瘦肉汤	饮食/2烹饪/2中国烹饪/2八大菜系/粤菜
白术猪肚汤	饮食/2烹饪/2中国烹饪/2八大菜系/粤菜
白果全鸭	饮食/2烹饪/2中国烹饪/2八大菜系/粤菜
白果南杏生鱼汤	饮食/2烹饪/2中国烹饪/2八大菜系/粤菜
白果扁豆支竹猪肚汤	饮食/2烹饪/2中国烹饪/2八大菜系/粤菜
白果杏贝鳄鱼肉汤	饮食/2烹饪/2中国烹饪/2八大菜系/粤菜
白果枝竹冬瓜老鸭汤	饮食/2烹饪/2中国烹饪/2八大菜系/粤菜
白果烧鸡	饮食/2烹饪/2中国烹饪/2八大菜系/粤菜
白果煲鸡	饮食/2烹饪/2中国烹饪/2八大菜系/粤菜
白果红烧鸡块	饮食/2烹饪/2中国烹饪/2八大菜系/粤菜
白果芋泥	饮食/2烹饪/2中国烹饪/2八大菜系/粤菜
白果薏米水	饮食/2烹饪/2中国烹饪/2八大菜系/粤菜
白果豆腐煎	饮食/2烹饪/2中国烹饪/2八大菜系/粤菜
白果鸡丁	饮食/2烹饪/2中国烹饪/2八大菜系/粤菜
白果鸡球	饮食/2烹饪/2中国烹饪/2八大菜系/粤菜
白果鸭煲	饮食/2烹饪/2中国烹饪/2八大菜系/粤菜
白榄炆白鳝	饮食/2烹饪/2中国烹饪/2八大菜系/粤菜
白汁甘笋	饮食/2烹饪/2中国烹饪/2八大菜系/粤菜
《炒鸭肠》	饮食/2烹饪/2中国烹饪/2八大菜系/粤菜
串烧海鲜	饮食/2烹饪/2中国烹饪/2八大菜系/粤菜
出水芙蓉鸭	饮食/2烹饪/2中国烹饪/2八大菜系/粤菜
参果炖瘦肉	饮食/2烹饪/2中国烹饪/2八大菜系/粤菜
参枣老鸽汤	饮食/2烹饪/2中国烹饪/2八大菜系/粤菜
参芪母鸡汤	饮食/2烹饪/2中国烹饪/2八大菜系/粤菜
参芪猴头菇炖鸡	饮食/2烹饪/2中国烹饪/2八大菜系/粤菜
参芪红枣生鱼汤	饮食/2烹饪/2中国烹饪/2八大菜系/粤菜
参附鸽	饮食/2烹饪/2中国烹饪/2八大菜系/粤菜
参麦雪梨瘦肉汤	饮食/2烹饪/2中国烹饪/2八大菜系/粤菜
叉烧炒面	饮食/2烹饪/2中国烹饪/2八大菜系/粤菜
叉烧肉便当	饮食/2烹饪/2中国烹饪/2八大菜系/粤菜
叉烧酱烧排骨	饮食/2烹饪/2中国烹饪/2八大菜系/粤菜
川椒蟹	饮食/2烹饪/2中国烹饪/2八大菜系/粤菜
川椒鸡	饮食/2烹饪/2中国烹饪/2八大菜系/粤菜
川贝母海蜇瘦肉汤	饮食/2烹饪/2中国烹饪/2八大菜系/粤菜
川贝炖鹧鸪	饮食/2烹饪/2中国烹饪/2八大菜系/粤菜
川贝芡实鹧鸪汤	饮食/2烹饪/2中国烹饪/2八大菜系/粤菜
川贝雪梨猪肺汤	饮食/2烹饪/2中国烹饪/2八大菜系/粤菜
彩丝腐皮卷	饮食/2烹饪/2中国烹饪/2八大菜系/粤菜
彩丝金柳	饮食/2烹饪/2中国烹饪/2八大菜系/粤菜
彩丝龙虾	饮食/2烹饪/2中国烹饪/2八大菜系/粤菜
彩扇碧蔬	饮食/2烹饪/2中国烹饪/2八大菜系/粤菜
彩椒炒香肠	饮食/2烹饪/2中国烹饪/2八大菜系/粤菜
彩虹鸡翅	饮食/2烹饪/2中国烹饪/2八大菜系/粤菜
春砂仁北芪猪肚汤	饮食/2烹饪/2中国烹饪/2八大菜系/粤菜
柴鱼贵妃粥	饮食/2烹饪/2中国烹饪/2八大菜系/粤菜
橙汁烩猪扒	饮食/2烹饪/2中国烹饪/2八大菜系/粤菜
橙汁百花茄盒	饮食/2烹饪/2中国烹饪/2八大菜系/粤菜
橙汁豆腐	饮食/2烹饪/2中国烹饪/2八大菜系/粤菜
橙皮香酱蒸乌头	饮食/2烹饪/2中国烹饪/2八大菜系/粤菜
池塘莲花	饮食/2烹饪/2中国烹饪/2八大菜系/粤菜
淳安辣椒酱	饮食/2烹饪/2中国烹饪/2八大菜系/粤菜
潮州伊府面	饮食/2烹饪/2中国烹饪/2八大菜系/粤菜
潮州冻肉	饮食/2烹饪/2中国烹饪/2八大菜系/粤菜
潮州卤水鹅片	饮食/2烹饪/2中国烹饪/2八大菜系/粤菜
潮州大排翅	饮食/2烹饪/2中国烹饪/2八大菜系/粤菜
潮州油果	饮食/2烹饪/2中国烹饪/2八大菜系/粤菜
潮州炒姜饭	饮食/2烹饪/2中国烹饪/2八大菜系/粤菜
潮州烧雁鹅	饮食/2烹饪/2中国烹饪/2八大菜系/粤菜
潮州生淋鱼	饮食/2烹饪/2中国烹饪/2八大菜系/粤菜
潮州翅	饮食/2烹饪/2中国烹饪/2八大菜系/粤菜
潮州肉冻	饮食/2烹饪/2中国烹饪/2八大菜系/粤菜
潮州脱骨掌	饮食/2烹饪/2中国烹饪/2八大菜系/粤菜
潮州蚝煎	饮食/2烹饪/2中国烹饪/2八大菜系/粤菜
潮州青榄猪粉肠汤	饮食/2烹饪/2中国烹饪/2八大菜系/粤菜
潮式芫荽狗肚鱼汤	饮食/2烹饪/2中国烹饪/2八大菜系/粤菜
潮式酿海参	饮食/2烹饪/2中国烹饪/2八大菜系/粤菜
潮式酿辽参	饮食/2烹饪/2中国烹饪/2八大菜系/粤菜
潮汕卤鹅	饮食/2烹饪/2中国烹饪/2八大菜系/粤菜
潮汕大鱼丸	饮食/2烹饪/2中国烹饪/2八大菜系/粤菜
潮汕护国菜	饮食/2烹饪/2中国烹饪/2八大菜系/粤菜
潮汕烧鸡	饮食/2烹饪/2中国烹饪/2八大菜系/粤菜
潮汕蚝烙	饮食/2烹饪/2中国烹饪/2八大菜系/粤菜
潮汕鱼丸	饮食/2烹饪/2中国烹饪/2八大菜系/粤菜
潮洲蒸粉果	饮食/2烹饪/2中国烹饪/2八大菜系/粤菜
炊太极虾	饮食/2烹饪/2中国烹饪/2八大菜系/粤菜
炊姜薯酵	饮食/2烹饪/2中国烹饪/2八大菜系/粤菜
炊水晶鸡	饮食/2烹饪/2中国烹饪/2八大菜系/粤菜
炊烟筒鸭	饮食/2烹饪/2中国烹饪/2八大菜系/粤菜
炊珍珠鸡	饮食/2烹饪/2中国烹饪/2八大菜系/粤菜
炊石榴鸡	饮食/2烹饪/2中国烹饪/2八大菜系/粤菜
炊米麸肉	饮食/2烹饪/2中国烹饪/2八大菜系/粤菜
炊莲花鸡	饮食/2烹饪/2中国烹饪/2八大菜系/粤菜
炊鱼翅盒	饮食/2烹饪/2中国烹饪/2八大菜系/粤菜
炊麒麟鱼	饮食/2烹饪/2中国烹饪/2八大菜系/粤菜
炒乳鸽松	饮食/2烹饪/2中国烹饪/2八大菜系/粤菜
炒十景	饮食/2烹饪/2中国烹饪/2八大菜系/粤菜
炒双鱿鱼	饮食/2烹饪/2中国烹饪/2八大菜系/粤菜
炒大明虾	饮食/2烹饪/2中国烹饪/2八大菜系/粤菜
炒川椒田鸡	饮食/2烹饪/2中国烹饪/2八大菜系/粤菜
炒川椒鹧鸪	饮食/2烹饪/2中国烹饪/2八大菜系/粤菜
炒干丝	饮食/2烹饪/2中国烹饪/2八大菜系/粤菜
炒扇贝	饮食/2烹饪/2中国烹饪/2八大菜系/粤菜
炒杏仁鸡丁	饮食/2烹饪/2中国烹饪/2八大菜系/粤菜
炒桂花翅	饮食/2烹饪/2中国烹饪/2八大菜系/粤菜
炒桂花鱿	饮食/2烹饪/2中国烹饪/2八大菜系/粤菜
炒甜面条	饮食/2烹饪/2中国烹饪/2八大菜系/粤菜
炒白鸽	饮食/2烹饪/2中国烹饪/2八大菜系/粤菜
炒白鸽松	饮食/2烹饪/2中国烹饪/2八大菜系/粤菜
炒禾花雀	饮食/2烹饪/2中国烹饪/2八大菜系/粤菜
炒素鳝	饮食/2烹饪/2中国烹饪/2八大菜系/粤菜
炒绵羊丝	饮食/2烹饪/2中国烹饪/2八大菜系/粤菜
炒芙蓉蟹	饮食/2烹饪/2中国烹饪/2八大菜系/粤菜
炒葫芦瓜	饮食/2烹饪/2中国烹饪/2八大菜系/粤菜
炒葱椒鸡	饮食/2烹饪/2中国烹饪/2八大菜系/粤菜
炒豆只鸡丁	饮食/2烹饪/2中国烹饪/2八大菜系/粤菜
炒香螺	饮食/2烹饪/2中国烹饪/2八大菜系/粤菜
炒鳝丝	饮食/2烹饪/2中国烹饪/2八大菜系/粤菜
炒鸡丝	饮食/2烹饪/2中国烹饪/2八大菜系/粤菜
炒鸡鹏	饮食/2烹饪/2中国烹饪/2八大菜系/粤菜
炒鸭肠	饮食/2烹饪/2中国烹饪/2八大菜系/粤菜
炒鹌鹑松	饮食/2烹饪/2中国烹饪/2八大菜系/粤菜
炒麦穗花鱿	饮食/2烹饪/2中国烹饪/2八大菜系/粤菜
炒麦穗鲜鱿	饮食/2烹饪/2中国烹饪/2八大菜系/粤菜
丁香鱼饺	饮食/2烹饪/2中国烹饪/2八大菜系/粤菜
东北家常锅包肉	饮食/2烹饪/2中国烹饪/2八大菜系/粤菜
东江东坡宴	饮食/2烹饪/2中国烹饪/2八大菜系/粤菜
东江瓤豆腐	饮食/2烹饪/2中国烹饪/2八大菜系/粤菜
东江盐H鸡	饮食/2烹饪/2中国烹饪/2八大菜系/粤菜
东江盐浸鸡	饮食/2烹饪/2中国烹饪/2八大菜系/粤菜
东江盐焗鸡	饮食/2烹饪/2中国烹饪/2八大菜系/粤菜
东江菜	饮食/2烹饪/2中国烹饪/2八大菜系/粤菜
东江豆腐煲	饮食/2烹饪/2中国烹饪/2八大菜系/粤菜
丹参黄豆汤	饮食/2烹饪/2中国烹饪/2八大菜系/粤菜
党参北芪乳鸽汤	饮食/2烹饪/2中国烹饪/2八大菜系/粤菜
党参北芪牛肚汤	饮食/2烹饪/2中国烹饪/2八大菜系/粤菜
党参淮山兔肉汤	饮食/2烹饪/2中国烹饪/2八大菜系/粤菜
党参百合猪肺汤	饮食/2烹饪/2中国烹饪/2八大菜系/粤菜
党参莲子鲤鱼汤	饮食/2烹饪/2中国烹饪/2八大菜系/粤菜
党参麦冬兔肉汤	饮食/2烹饪/2中国烹饪/2八大菜系/粤菜
党参麦冬瘦肉汤	饮食/2烹饪/2中国烹饪/2八大菜系/粤菜
党参黄芪炖鸡汤	饮食/2烹饪/2中国烹饪/2八大菜系/粤菜
冬杏田鸡精	饮食/2烹饪/2中国烹饪/2八大菜系/粤菜
冬瓜冬菜泥鱼孟鱼汤	饮食/2烹饪/2中国烹饪/2八大菜系/粤菜
冬瓜干贝炖田鸡	饮食/2烹饪/2中国烹饪/2八大菜系/粤菜
冬瓜干贝羹	饮食/2烹饪/2中国烹饪/2八大菜系/粤菜
冬瓜扣鸭	饮食/2烹饪/2中国烹饪/2八大菜系/粤菜
冬瓜排骨清汤	饮食/2烹饪/2中国烹饪/2八大菜系/粤菜
冬瓜水蟹猪排骨汤	饮食/2烹饪/2中国烹饪/2八大菜系/粤菜
冬瓜汤谱	饮食/2烹饪/2中国烹饪/2八大菜系/粤菜
冬瓜煲汤	饮食/2烹饪/2中国烹饪/2八大菜系/粤菜
冬瓜煲田鸡	饮食/2烹饪/2中国烹饪/2八大菜系/粤菜
冬瓜甑	饮食/2烹饪/2中国烹饪/2八大菜系/粤菜
冬瓜羹	饮食/2烹饪/2中国烹饪/2八大菜系/粤菜
冬瓜荷叶薏米排骨汤	饮食/2烹饪/2中国烹饪/2八大菜系/粤菜
冬瓜菠萝羹	饮食/2烹饪/2中国烹饪/2八大菜系/粤菜
冬瓜薏米煲鸭	饮食/2烹饪/2中国烹饪/2八大菜系/粤菜
冬瓜赤小豆金银肾汤	饮食/2烹饪/2中国烹饪/2八大菜系/粤菜
冬瓜陈皮薏米瘦肉汤	饮食/2烹饪/2中国烹饪/2八大菜系/粤菜
冬瓜鲜荷叶煲鸭	饮食/2烹饪/2中国烹饪/2八大菜系/粤菜
冬瓜鳢鱼汤	饮食/2烹饪/2中国烹饪/2八大菜系/粤菜
冬笋炆猫肉	饮食/2烹饪/2中国烹饪/2八大菜系/粤菜
冬笋炒牛肉	饮食/2烹饪/2中国烹饪/2八大菜系/粤菜
冬笋焖菰	饮食/2烹饪/2中国烹饪/2八大菜系/粤菜
冬茹丝冬瓜肉粒汤	饮食/2烹饪/2中国烹饪/2八大菜系/粤菜
冬荷煲老鸭汤	饮食/2烹饪/2中国烹饪/2八大菜系/粤菜
冬菇扒茼蒿	饮食/2烹饪/2中国烹饪/2八大菜系/粤菜
冬菇蒸滑鸡	饮食/2烹饪/2中国烹饪/2八大菜系/粤菜
冬菇马蹄腊鸭汤	饮食/2烹饪/2中国烹饪/2八大菜系/粤菜
冬菇马蹄苋菜豆腐羹	饮食/2烹饪/2中国烹饪/2八大菜系/粤菜
冬菇鸡脚汤	饮食/2烹饪/2中国烹饪/2八大菜系/粤菜
冬菰焖双笋	饮食/2烹饪/2中国烹饪/2八大菜系/粤菜
冬虫夏草童子鸡汤	饮食/2烹饪/2中国烹饪/2八大菜系/粤菜
冬虫夏草龟汤	饮食/2烹饪/2中国烹饪/2八大菜系/粤菜
冬虫草珧柱猪展汤	饮食/2烹饪/2中国烹饪/2八大菜系/粤菜
冻豆腐金针	饮食/2烹饪/2中国烹饪/2八大菜系/粤菜
冻金钟鸡	饮食/2烹饪/2中国烹饪/2八大菜系/粤菜
剁椒蒸鳊鱼	饮食/2烹饪/2中国烹饪/2八大菜系/粤菜
地胆头炖猪月展	饮食/2烹饪/2中国烹饪/2八大菜系/粤菜
大地鱼滚豆腐汤	饮食/2烹饪/2中国烹饪/2八大菜系/粤菜
大地鱼猪瘦肉滚豆腐汤	饮食/2烹饪/2中国烹饪/2八大菜系/粤菜
大地鹌鹑片	饮食/2烹饪/2中国烹饪/2八大菜系/粤菜
大枣姜汤	饮食/2烹饪/2中国烹饪/2八大菜系/粤菜
大枣淮山牛展汤	饮食/2烹饪/2中国烹饪/2八大菜系/粤菜
大树菠萝核煲瘦肉	饮食/2烹饪/2中国烹饪/2八大菜系/粤菜
大白菜猪脷排骨汤	饮食/2烹饪/2中国烹饪/2八大菜系/粤菜
大良炒鲜奶	饮食/2烹饪/2中国烹饪/2八大菜系/粤菜
大良炒鲜牛奶	饮食/2烹饪/2中国烹饪/2八大菜系/粤菜
大良肉卷	饮食/2烹饪/2中国烹饪/2八大菜系/粤菜
大良野鸡卷	饮食/2烹饪/2中国烹饪/2八大菜系/粤菜
大芥菜滚牛肉片	饮食/2烹饪/2中国烹饪/2八大菜系/粤菜
大芥菜腊鸭头排骨汤	饮食/2烹饪/2中国烹饪/2八大菜系/粤菜
大蒜煮萝卜	饮食/2烹饪/2中国烹饪/2八大菜系/粤菜
大蒜野鸭汤	饮食/2烹饪/2中国烹饪/2八大菜系/粤菜
大薯蚝豉猪骨汤	饮食/2烹饪/2中国烹饪/2八大菜系/粤菜
大豆芽荠苨党参猪腰汤	饮食/2烹饪/2中国烹饪/2八大菜系/粤菜
大豆芽菜滚鸡丝汤	饮食/2烹饪/2中国烹饪/2八大菜系/粤菜
大豆荠苨猪腰汤	饮食/2烹饪/2中国烹饪/2八大菜系/粤菜
大锅狗	饮食/2烹饪/2中国烹饪/2八大菜系/粤菜
大鱼头豆腐汤	饮食/2烹饪/2中国烹饪/2八大菜系/粤菜
杜仲山楂猪肚汤	饮食/2烹饪/2中国烹饪/2八大菜系/粤菜
杜仲淮山鹌鹑汤	饮食/2烹饪/2中国烹饪/2八大菜系/粤菜
杜仲牛孖筋汤	饮食/2烹饪/2中国烹饪/2八大菜系/粤菜
淡糟香螺片	饮食/2烹饪/2中国烹饪/2八大菜系/粤菜
淡菜淮实山斑鱼汤	饮食/2烹饪/2中国烹饪/2八大菜系/粤菜
淡菜紫菜瘦肉汤	饮食/2烹饪/2中国烹饪/2八大菜系/粤菜
灯芯花莲子牛百叶汤	饮食/2烹饪/2中国烹饪/2八大菜系/粤菜
炖人参汤	饮食/2烹饪/2中国烹饪/2八大菜系/粤菜
炖柠檬鸭	饮食/2烹饪/2中国烹饪/2八大菜系/粤菜
炖橄榄螺头汤	饮食/2烹饪/2中国烹饪/2八大菜系/粤菜
炖禾虫	饮食/2烹饪/2中国烹饪/2八大菜系/粤菜
炖豆腐猪蹄香菇	饮食/2烹饪/2中国烹饪/2八大菜系/粤菜
炖鱼翅骨	饮食/2烹饪/2中国烹饪/2八大菜系/粤菜
独脚金瘦肉汤	饮食/2烹饪/2中国烹饪/2八大菜系/粤菜
电饭锅盐焗手撕鸡	饮食/2烹饪/2中国烹饪/2八大菜系/粤菜
二姐兔丁	饮食/2烹饪/2中国烹饪/2八大菜系/粤菜
佛手排骨	饮食/2烹饪/2中国烹饪/2八大菜系/粤菜
凤吞翅	饮食/2烹饪/2中国烹饪/2八大菜系/粤菜
凤尾大虾	饮食/2烹饪/2中国烹饪/2八大菜系/粤菜
凤梨咕噜虾球	饮食/2烹饪/2中国烹饪/2八大菜系/粤菜
凤梨烩排骨	饮食/2烹饪/2中国烹饪/2八大菜系/粤菜
反沙姜薯	饮食/2烹饪/2中国烹饪/2八大菜系/粤菜
反沙潮州柑	饮食/2烹饪/2中国烹饪/2八大菜系/粤菜
反沙银杏	饮食/2烹饪/2中国烹饪/2八大菜系/粤菜
反沙香芋	饮食/2烹饪/2中国烹饪/2八大菜系/粤菜
发菜扒大鸭	饮食/2烹饪/2中国烹饪/2八大菜系/粤菜
发菜火腩焖蚝豉	饮食/2烹饪/2中国烹饪/2八大菜系/粤菜
发菜蚝豉汤	饮食/2烹饪/2中国烹饪/2八大菜系/粤菜
发菜长生汤	饮食/2烹饪/2中国烹饪/2八大菜系/粤菜
发菜鱼丸汤	饮食/2烹饪/2中国烹饪/2八大菜系/粤菜
发财好事	饮食/2烹饪/2中国烹饪/2八大菜系/粤菜
富贵手撕鸡	饮食/2烹饪/2中国烹饪/2八大菜系/粤菜
富贵有鱼	饮食/2烹饪/2中国烹饪/2八大菜系/粤菜
富贵满粥	饮食/2烹饪/2中国烹饪/2八大菜系/粤菜
富贵黄金卷	饮食/2烹饪/2中国烹饪/2八大菜系/粤菜
法国奶油蟹肉黑麦金笋	饮食/2烹饪/2中国烹饪/2八大菜系/粤菜
浮小麦参淮牛展汤	饮食/2烹饪/2中国烹饪/2八大菜系/粤菜
番茄咸猪肉汤	饮食/2烹饪/2中国烹饪/2八大菜系/粤菜
番茄山斑鱼汤	饮食/2烹饪/2中国烹饪/2八大菜系/粤菜
番茄拌豆腐	饮食/2烹饪/2中国烹饪/2八大菜系/粤菜
番茄海蜇	饮食/2烹饪/2中国烹饪/2八大菜系/粤菜
番茄炒豆腐	饮食/2烹饪/2中国烹饪/2八大菜系/粤菜
番茄煮红衫鱼	饮食/2烹饪/2中国烹饪/2八大菜系/粤菜
番茄牛肉羹	饮食/2烹饪/2中国烹饪/2八大菜系/粤菜
番茄蕨菜绣球	饮食/2烹饪/2中国烹饪/2八大菜系/粤菜
番茄薯仔牛尾汤	饮食/2烹饪/2中国烹饪/2八大菜系/粤菜
番茄蛋花汤	饮食/2烹饪/2中国烹饪/2八大菜系/粤菜
番茄黄骨鱼汤	饮食/2烹饪/2中国烹饪/2八大菜系/粤菜
《枸杞粥》	饮食/2烹饪/2中国烹饪/2八大菜系/粤菜
古法扣全瑞	饮食/2烹饪/2中国烹饪/2八大菜系/粤菜
古法扣全端	饮食/2烹饪/2中国烹饪/2八大菜系/粤菜
咕咾肉便当	饮食/2烹饪/2中国烹饪/2八大菜系/粤菜
咕咾肉烩饭	饮食/2烹饪/2中国烹饪/2八大菜系/粤菜
咕噜牛排	饮食/2烹饪/2中国烹饪/2八大菜系/粤菜
咕噜牛肉	饮食/2烹饪/2中国烹饪/2八大菜系/粤菜
咕噜肉	饮食/2烹饪/2中国烹饪/2八大菜系/粤菜
宫庭献鱼	饮食/2烹饪/2中国烹饪/2八大菜系/粤菜
干炸五香鸡块	饮食/2烹饪/2中国烹饪/2八大菜系/粤菜
干炸大蚝	饮食/2烹饪/2中国烹饪/2八大菜系/粤菜
干炸果肉	饮食/2烹饪/2中国烹饪/2八大菜系/粤菜
干炸肝花	饮食/2烹饪/2中国烹饪/2八大菜系/粤菜
干炸虾枣	饮食/2烹饪/2中国烹饪/2八大菜系/粤菜
干炸虾筒	饮食/2烹饪/2中国烹饪/2八大菜系/粤菜
干炸蟹塔	饮食/2烹饪/2中国烹饪/2八大菜系/粤菜
干炸蟹枣	饮食/2烹饪/2中国烹饪/2八大菜系/粤菜
干炸鱼盒	饮食/2烹饪/2中国烹饪/2八大菜系/粤菜
干烧冬笋	饮食/2烹饪/2中国烹饪/2八大菜系/粤菜
干烧凤翼翅	饮食/2烹饪/2中国烹饪/2八大菜系/粤菜
干焗蟹塔	饮食/2烹饪/2中国烹饪/2八大菜系/粤菜
干煸牛腩	饮食/2烹饪/2中国烹饪/2八大菜系/粤菜
干菊花粥	饮食/2烹饪/2中国烹饪/2八大菜系/粤菜
干贝发菜	饮食/2烹饪/2中国烹饪/2八大菜系/粤菜
干贝汤	饮食/2烹饪/2中国烹饪/2八大菜系/粤菜
干贝鸡脚翼	饮食/2烹饪/2中国烹饪/2八大菜系/粤菜
广东叉烧包	饮食/2烹饪/2中国烹饪/2八大菜系/粤菜
广东文昌鸡	饮食/2烹饪/2中国烹饪/2八大菜系/粤菜
广东月饼	饮食/2烹饪/2中国烹饪/2八大菜系/粤菜
广东油鸡	饮食/2烹饪/2中国烹饪/2八大菜系/粤菜
广东油鸡淋酱	饮食/2烹饪/2中国烹饪/2八大菜系/粤菜
广东泡菜	饮食/2烹饪/2中国烹饪/2八大菜系/粤菜
广东烤鸭	饮食/2烹饪/2中国烹饪/2八大菜系/粤菜
广东烧腊饭	饮食/2烹饪/2中国烹饪/2八大菜系/粤菜
广东烩饭	饮食/2烹饪/2中国烹饪/2八大菜系/粤菜
广东盐鸡	饮食/2烹饪/2中国烹饪/2八大菜系/粤菜
广东粉果	饮食/2烹饪/2中国烹饪/2八大菜系/粤菜
广东肉	饮食/2烹饪/2中国烹饪/2八大菜系/粤菜
广东虾饺	饮食/2烹饪/2中国烹饪/2八大菜系/粤菜
广州文昌鸡	饮食/2烹饪/2中国烹饪/2八大菜系/粤菜
广州新东方烹饪学院	饮食/2烹饪/2中国烹饪/2八大菜系/粤菜
广州炒饭	饮食/2烹饪/2中国烹饪/2八大菜系/粤菜
广式卤鸭翅	饮食/2烹饪/2中国烹饪/2八大菜系/粤菜
广式回锅肉	饮食/2烹饪/2中国烹饪/2八大菜系/粤菜
广式滷鸭翅	饮食/2烹饪/2中国烹饪/2八大菜系/粤菜
广式点心	饮食/2烹饪/2中国烹饪/2八大菜系/粤菜
广式烧填鸭	饮食/2烹饪/2中国烹饪/2八大菜系/粤菜
广式羊肉煲	饮食/2烹饪/2中国烹饪/2八大菜系/粤菜
广式饺子	饮食/2烹饪/2中国烹饪/2八大菜系/粤菜
广式香炒面	饮食/2烹饪/2中国烹饪/2八大菜系/粤菜
广式马蹄糕	饮食/2烹饪/2中国烹饪/2八大菜系/粤菜
怪味鲜鱿鱼	饮食/2烹饪/2中国烹饪/2八大菜系/粤菜
果仁百合	饮食/2烹饪/2中国烹饪/2八大菜系/粤菜
果汁煎肉脯	饮食/2烹饪/2中国烹饪/2八大菜系/粤菜
果汁肉脯	饮食/2烹饪/2中国烹饪/2八大菜系/粤菜
果汁鱼块	饮食/2烹饪/2中国烹饪/2八大菜系/粤菜
果汁鹌鹑	饮食/2烹饪/2中国烹饪/2八大菜系/粤菜
枸杞子南枣鸽蛋汤	饮食/2烹饪/2中国烹饪/2八大菜系/粤菜
枸杞牛肝汤	饮食/2烹饪/2中国烹饪/2八大菜系/粤菜
枸杞粥	饮食/2烹饪/2中国烹饪/2八大菜系/粤菜
枸杞菊花煲排骨	饮食/2烹饪/2中国烹饪/2八大菜系/粤菜
桂圆百合炖鹌鹑	饮食/2烹饪/2中国烹饪/2八大菜系/粤菜
桂鱼虾干泡丝瓜	饮食/2烹饪/2中国烹饪/2八大菜系/粤菜
橄榄炖鸡	饮食/2烹饪/2中国烹饪/2八大菜系/粤菜
港式糯米饭	饮食/2烹饪/2中国烹饪/2八大菜系/粤菜
灌汤龙凤球	饮食/2烹饪/2中国烹饪/2八大菜系/粤菜
狗肉煲	饮食/2烹饪/2中国烹饪/2八大菜系/粤菜
狗肚鱼大芥菜汤	饮食/2烹饪/2中国烹饪/2八大菜系/粤菜
狗肝菜冰糖汤	饮食/2烹饪/2中国烹饪/2八大菜系/粤菜
甘柠芝麻虾	饮食/2烹饪/2中国烹饪/2八大菜系/粤菜
甘甜黑巧克力	饮食/2烹饪/2中国烹饪/2八大菜系/粤菜
甘菊猪肚	饮食/2烹饪/2中国烹饪/2八大菜系/粤菜
何首乌鲜鸡汤	饮食/2烹饪/2中国烹饪/2八大菜系/粤菜
化积解热饮	饮食/2烹饪/2中国烹饪/2八大菜系/粤菜
厚菰荠菜	饮食/2烹饪/2中国烹饪/2八大菜系/粤菜
合掌瓜猪踭汤	饮食/2烹饪/2中国烹饪/2八大菜系/粤菜
哈密瓜苹果猪瘦肉汤	饮食/2烹饪/2中国烹饪/2八大菜系/粤菜
护国素菜	饮食/2烹饪/2中国烹饪/2八大菜系/粤菜
核桃仁炖蚕蛹	饮食/2烹饪/2中国烹饪/2八大菜系/粤菜
核桃杜仲首乌羊肉汤	饮食/2烹饪/2中国烹饪/2八大菜系/粤菜
核桃淡菜番鸭汤	饮食/2烹饪/2中国烹饪/2八大菜系/粤菜
核桃淮山芡实猪展汤	饮食/2烹饪/2中国烹饪/2八大菜系/粤菜
核桃瘦肉海马汤	饮食/2烹饪/2中国烹饪/2八大菜系/粤菜
核桃红米饭	饮食/2烹饪/2中国烹饪/2八大菜系/粤菜
核桃马来糕	饮食/2烹饪/2中国烹饪/2八大菜系/粤菜
核桃鸡汤	饮食/2烹饪/2中国烹饪/2八大菜系/粤菜
核桃龙眼炒鸡丁	饮食/2烹饪/2中国烹饪/2八大菜系/粤菜
槐花木耳猪肚汤	饮食/2烹饪/2中国烹饪/2八大菜系/粤菜
槐花牛脾汤	饮食/2烹饪/2中国烹饪/2八大菜系/粤菜
槐花猪肠汤	饮食/2烹饪/2中国烹饪/2八大菜系/粤菜
活河鲤	饮食/2烹饪/2中国烹饪/2八大菜系/粤菜
海南椰子盅	饮食/2烹饪/2中国烹饪/2八大菜系/粤菜
海参木耳汤	饮食/2烹饪/2中国烹饪/2八大菜系/粤菜
海参炖瘦肉	饮食/2烹饪/2中国烹饪/2八大菜系/粤菜
海参焖冬菇	饮食/2烹饪/2中国烹饪/2八大菜系/粤菜
海参肉苁蓉瘦肉汤	饮食/2烹饪/2中国烹饪/2八大菜系/粤菜
海带夏枯草炖鸽肉汤	饮食/2烹饪/2中国烹饪/2八大菜系/粤菜
海带清热汤	饮食/2烹饪/2中国烹饪/2八大菜系/粤菜
海带猪骨汤	饮食/2烹饪/2中国烹饪/2八大菜系/粤菜
海带绿豆花生鲨鱼骨汤	饮食/2烹饪/2中国烹饪/2八大菜系/粤菜
海带萝卜汤	饮食/2烹饪/2中国烹饪/2八大菜系/粤菜
海棠冬菇	饮食/2烹饪/2中国烹饪/2八大菜系/粤菜
海棠冬菰	饮食/2烹饪/2中国烹饪/2八大菜系/粤菜
海蛤冬瓜汤	饮食/2烹饪/2中国烹饪/2八大菜系/粤菜
海蜇火腿羹	饮食/2烹饪/2中国烹饪/2八大菜系/粤菜
淮山响螺鲜鸡汤	饮食/2烹饪/2中国烹饪/2八大菜系/粤菜
淮山杞子圆肉炖猪脑	饮食/2烹饪/2中国烹饪/2八大菜系/粤菜
淮山杞子山斑鱼汤	饮食/2烹饪/2中国烹饪/2八大菜系/粤菜
淮山核桃肉羊肉汤	饮食/2烹饪/2中国烹饪/2八大菜系/粤菜
淮山沙参玉竹鹅肉汤	饮食/2烹饪/2中国烹饪/2八大菜系/粤菜
淮山芡实山班鱼汤	饮食/2烹饪/2中国烹饪/2八大菜系/粤菜
淮山芡实炖鱼肚	饮食/2烹饪/2中国烹饪/2八大菜系/粤菜
淮山芡实莲子雪耳排骨	饮食/2烹饪/2中国烹饪/2八大菜系/粤菜
淮山薏米羊肾汤	饮食/2烹饪/2中国烹饪/2八大菜系/粤菜
淮山黄芪猪横脷汤	饮食/2烹饪/2中国烹饪/2八大菜系/粤菜
淮杞塘虱鱼汤	饮食/2烹饪/2中国烹饪/2八大菜系/粤菜
淮杞浸乌鸡	饮食/2烹饪/2中国烹饪/2八大菜系/粤菜
淮杞炖羊肉	饮食/2烹饪/2中国烹饪/2八大菜系/粤菜
淮杞鸡脚响螺汤	饮食/2烹饪/2中国烹饪/2八大菜系/粤菜
滑炒山药	饮食/2烹饪/2中国烹饪/2八大菜系/粤菜
滑蛋牛肉	饮食/2烹饪/2中国烹饪/2八大菜系/粤菜
滑蛋虾仁	饮食/2烹饪/2中国烹饪/2八大菜系/粤菜
火炭母猪红汤	饮食/2烹饪/2中国烹饪/2八大菜系/粤菜
火焰醉虾	饮食/2烹饪/2中国烹饪/2八大菜系/粤菜
火腿肉滚茼蒿汤	饮食/2烹饪/2中国烹饪/2八大菜系/粤菜
火边子牛肉	饮食/2烹饪/2中国烹饪/2八大菜系/粤菜
火鸭白菜丝	饮食/2烹饪/2中国烹饪/2八大菜系/粤菜
火麻仁当归猪展汤	饮食/2烹饪/2中国烹饪/2八大菜系/粤菜
火麻仁瘦肉汤	饮食/2烹饪/2中国烹饪/2八大菜系/粤菜
烩发菜羹	饮食/2烹饪/2中国烹饪/2八大菜系/粤菜
烩神仙鱼翅	饮食/2烹饪/2中国烹饪/2八大菜系/粤菜
猴头菇炖北菇	饮食/2烹饪/2中国烹饪/2八大菜系/粤菜
猴头菇炖竹丝鸡	饮食/2烹饪/2中国烹饪/2八大菜系/粤菜
猴头菇白果鲨鱼骨汤	饮食/2烹饪/2中国烹饪/2八大菜系/粤菜
猴脑汤	饮食/2烹饪/2中国烹饪/2八大菜系/粤菜
猴菇花枝饺	饮食/2烹饪/2中国烹饪/2八大菜系/粤菜
京式酸辣汤	饮食/2烹饪/2中国烹饪/2八大菜系/粤菜
京酱芥兰菜	饮食/2烹饪/2中国烹饪/2八大菜系/粤菜
健脾祛暑三豆汤	饮食/2烹饪/2中国烹饪/2八大菜系/粤菜
决明子粥	饮食/2烹饪/2中国烹饪/2八大菜系/粤菜
剑花白鳝汤	饮食/2烹饪/2中国烹饪/2八大菜系/粤菜
剑花蜜枣猪肺汤	饮食/2烹饪/2中国烹饪/2八大菜系/粤菜
剑花马蹄白鳝汤	饮食/2烹饪/2中国烹饪/2八大菜系/粤菜
卷心菜洋葱汁	饮食/2烹饪/2中国烹饪/2八大菜系/粤菜
吉列海鲜卷	饮食/2烹饪/2中国烹饪/2八大菜系/粤菜
姜丝焗肉蟹	饮食/2烹饪/2中国烹饪/2八大菜系/粤菜
姜丝肉蟹	饮食/2烹饪/2中国烹饪/2八大菜系/粤菜
姜汁拌菠菜	饮食/2烹饪/2中国烹饪/2八大菜系/粤菜
姜茸柠檬锔鸡腿	饮食/2烹饪/2中国烹饪/2八大菜系/粤菜
姜葱炒蟹	饮食/2烹饪/2中国烹饪/2八大菜系/粤菜
姜葱煀鲤鱼	饮食/2烹饪/2中国烹饪/2八大菜系/粤菜
姜葱苏叶橄榄汤	饮食/2烹饪/2中国烹饪/2八大菜系/粤菜
姜葱蚬芥蒸鱼云	饮食/2烹饪/2中国烹饪/2八大菜系/粤菜
姜葱螃蟹	饮食/2烹饪/2中国烹饪/2八大菜系/粤菜
姜薯锂鱼	饮食/2烹饪/2中国烹饪/2八大菜系/粤菜
姜醋蛋	饮食/2烹饪/2中国烹饪/2八大菜系/粤菜
家乡秋茄	饮食/2烹饪/2中国烹饪/2八大菜系/粤菜
家传火焗鸭	饮食/2烹饪/2中国烹饪/2八大菜系/粤菜
家庭八宝冬瓜盅	饮食/2烹饪/2中国烹饪/2八大菜系/粤菜
家鄉鹹水餃	饮食/2烹饪/2中国烹饪/2八大菜系/粤菜
椒盐爆中虾	饮食/2烹饪/2中国烹饪/2八大菜系/粤菜
椒盐牛排	饮食/2烹饪/2中国烹饪/2八大菜系/粤菜
椒盐虾	饮食/2烹饪/2中国烹饪/2八大菜系/粤菜
江南百花鸡	饮食/2烹饪/2中国烹饪/2八大菜系/粤菜
江瑶柱大白菜汤	饮食/2烹饪/2中国烹饪/2八大菜系/粤菜
浇头耗油生菜	饮食/2烹饪/2中国烹饪/2八大菜系/粤菜
煎丸子	饮食/2烹饪/2中国烹饪/2八大菜系/粤菜
煎寸金虾	饮食/2烹饪/2中国烹饪/2八大菜系/粤菜
煎封福寿鱼	饮食/2烹饪/2中国烹饪/2八大菜系/粤菜
煎封鲳鱼	饮食/2烹饪/2中国烹饪/2八大菜系/粤菜
煎封黄花鱼	饮食/2烹饪/2中国烹饪/2八大菜系/粤菜
煎有鱼烙	饮食/2烹饪/2中国烹饪/2八大菜系/粤菜
煎秋瓜烙	饮食/2烹饪/2中国烹饪/2八大菜系/粤菜
煎酿苦瓜	饮食/2烹饪/2中国烹饪/2八大菜系/粤菜
煎金钱牛柳	饮食/2烹饪/2中国烹饪/2八大菜系/粤菜
爵士奶皇包	饮食/2烹饪/2中国烹饪/2八大菜系/粤菜
口福鸡	饮食/2烹饪/2中国烹饪/2八大菜系/粤菜
咖哩草菇	饮食/2烹饪/2中国烹饪/2八大菜系/粤菜
咖哩饺	饮食/2烹饪/2中国烹饪/2八大菜系/粤菜
咖喱樱桃	饮食/2烹饪/2中国烹饪/2八大菜系/粤菜
咖喱焖鸡	饮食/2烹饪/2中国烹饪/2八大菜系/粤菜
咖喱鸡丝羹	饮食/2烹饪/2中国烹饪/2八大菜系/粤菜
扣环球上汤	饮食/2烹饪/2中国烹饪/2八大菜系/粤菜
昆布海澡瘦肉汤	饮食/2烹饪/2中国烹饪/2八大菜系/粤菜
昆布海藻煲黄豆汤	饮食/2烹饪/2中国烹饪/2八大菜系/粤菜
昆布海藻猪踭汤	饮食/2烹饪/2中国烹饪/2八大菜系/粤菜
烤乳猪	饮食/2烹饪/2中国烹饪/2八大菜系/粤菜
烤广式三层肉	饮食/2烹饪/2中国烹饪/2八大菜系/粤菜
烤网油肝花	饮食/2烹饪/2中国烹饪/2八大菜系/粤菜
两吃多宝鱼	饮食/2烹饪/2中国烹饪/2八大菜系/粤菜
两情相悦	饮食/2烹饪/2中国烹饪/2八大菜系/粤菜
兰度鸽脯	饮食/2烹饪/2中国烹饪/2八大菜系/粤菜
兰花金钱酿发菜	饮食/2烹饪/2中国烹饪/2八大菜系/粤菜
凉冻五果	饮食/2烹饪/2中国烹饪/2八大菜系/粤菜
凉冻蟹钳	饮食/2烹饪/2中国烹饪/2八大菜系/粤菜
凉冻金钟鸡	饮食/2烹饪/2中国烹饪/2八大菜系/粤菜
凉拌三色	饮食/2烹饪/2中国烹饪/2八大菜系/粤菜
凉拌橘子鸭	饮食/2烹饪/2中国烹饪/2八大菜系/粤菜
凉拌牛蒡	饮食/2烹饪/2中国烹饪/2八大菜系/粤菜
凉拌生鱼片	饮食/2烹饪/2中国烹饪/2八大菜系/粤菜
凉拌白萝卜丝	饮食/2烹饪/2中国烹饪/2八大菜系/粤菜
凉拌蚌羹	饮食/2烹饪/2中国烹饪/2八大菜系/粤菜
凉拌辣味螺	饮食/2烹饪/2中国烹饪/2八大菜系/粤菜
凉瓜八宝炖汤	饮食/2烹饪/2中国烹饪/2八大菜系/粤菜
凉瓜干水瓜壳煲龙骨	饮食/2烹饪/2中国烹饪/2八大菜系/粤菜
凉瓜浸田鸡	饮食/2烹饪/2中国烹饪/2八大菜系/粤菜
凉瓜肉排汤	饮食/2烹饪/2中国烹饪/2八大菜系/粤菜
拉糟鱼块	饮食/2烹饪/2中国烹饪/2八大菜系/粤菜
栗子冬菇凤爪排骨汤	饮食/2烹饪/2中国烹饪/2八大菜系/粤菜
栗子冬菇鲜鸡汤	饮食/2烹饪/2中国烹饪/2八大菜系/粤菜
栗子南杏鲜鸡汤	饮食/2烹饪/2中国烹饪/2八大菜系/粤菜
栗子淮山猪蹄汤	饮食/2烹饪/2中国烹饪/2八大菜系/粤菜
栗子焖鸡	饮食/2烹饪/2中国烹饪/2八大菜系/粤菜
栗子焖鸭	饮食/2烹饪/2中国烹饪/2八大菜系/粤菜
栗子莲子猪腰汤	饮食/2烹饪/2中国烹饪/2八大菜系/粤菜
梨汁牛奶羹	饮食/2烹饪/2中国烹饪/2八大菜系/粤菜
榄仁发财卷	饮食/2烹饪/2中国烹饪/2八大菜系/粤菜
榴莲煲鸡汤	饮食/2烹饪/2中国烹饪/2八大菜系/粤菜
榴莲芯煲鲫鱼汤	饮食/2烹饪/2中国烹饪/2八大菜系/粤菜
榴莲鲜鸡汤	饮食/2烹饪/2中国烹饪/2八大菜系/粤菜
溜肝尖	饮食/2烹饪/2中国烹饪/2八大菜系/粤菜
溜腰花	饮食/2烹饪/2中国烹饪/2八大菜系/粤菜
溜黄菜	饮食/2烹饪/2中国烹饪/2八大菜系/粤菜
灵芝云苓炖水龟	饮食/2烹饪/2中国烹饪/2八大菜系/粤菜
灵芝蜜枣瘦肉汤	饮食/2烹饪/2中国烹饪/2八大菜系/粤菜
《么么喳喳珍珠糖水》	饮食/2烹饪/2中国烹饪/2八大菜系/粤菜
《梅花粥》	饮食/2烹饪/2中国烹饪/2八大菜系/粤菜
么么喳喳珍珠糖水	饮食/2烹饪/2中国烹饪/2八大菜系/粤菜
墨鱼干节瓜煲猪踭	饮食/2烹饪/2中国烹饪/2八大菜系/粤菜
明炉梅子鸭	饮食/2烹饪/2中国烹饪/2八大菜系/粤菜
明炉竹筒鱼	饮食/2烹饪/2中国烹饪/2八大菜系/粤菜
明炉鸡卷	饮食/2烹饪/2中国烹饪/2八大菜系/粤菜
木棉花粉葛煲竹丝鸡三	饮食/2烹饪/2中国烹饪/2八大菜系/粤菜
木瓜墨鱼汤	饮食/2烹饪/2中国烹饪/2八大菜系/粤菜
木瓜煲老鸭	饮食/2烹饪/2中国烹饪/2八大菜系/粤菜
木瓜牙带鱼汤	饮食/2烹饪/2中国烹饪/2八大菜系/粤菜
木瓜生鱼汤	饮食/2烹饪/2中国烹饪/2八大菜系/粤菜
木瓜粟米花生生鱼汤	饮食/2烹饪/2中国烹饪/2八大菜系/粤菜
木瓜翅骨	饮食/2烹饪/2中国烹饪/2八大菜系/粤菜
木瓜花生鸡脚汤	饮食/2烹饪/2中国烹饪/2八大菜系/粤菜
木瓜蛤油	饮食/2烹饪/2中国烹饪/2八大菜系/粤菜
木瓜雪耳猪骨汤	饮食/2烹饪/2中国烹饪/2八大菜系/粤菜
木瓜鱼尾花生汤	饮食/2烹饪/2中国烹饪/2八大菜系/粤菜
木耳海参猪肠汤	饮食/2烹饪/2中国烹饪/2八大菜系/粤菜
木耳炒肉片	饮食/2烹饪/2中国烹饪/2八大菜系/粤菜
木耳红枣粥	饮食/2烹饪/2中国烹饪/2八大菜系/粤菜
木耳鸡蛋炒鸡丁	饮食/2烹饪/2中国烹饪/2八大菜系/粤菜
梅子甑鹅	饮食/2烹饪/2中国烹饪/2八大菜系/粤菜
梅干菜烧肉	饮食/2烹饪/2中国烹饪/2八大菜系/粤菜
梅膏屈猪脚	饮食/2烹饪/2中国烹饪/2八大菜系/粤菜
梅花粥	饮食/2烹饪/2中国烹饪/2八大菜系/粤菜
梅菜扒鸭	饮食/2烹饪/2中国烹饪/2八大菜系/粤菜
梅香茄子煲	饮食/2烹饪/2中国烹饪/2八大菜系/粤菜
毛冬青杞子菟丝子猪瘦	饮食/2烹饪/2中国烹饪/2八大菜系/粤菜
毛冬青豕希莶草猪脚汤	饮食/2烹饪/2中国烹饪/2八大菜系/粤菜
满地黄金	饮食/2烹饪/2中国烹饪/2八大菜系/粤菜
焖三仙菜胆	饮食/2烹饪/2中国烹饪/2八大菜系/粤菜
焖三仙鸭掌	饮食/2烹饪/2中国烹饪/2八大菜系/粤菜
焖三仙鸽蛋	饮食/2烹饪/2中国烹饪/2八大菜系/粤菜
焖厚菰珠瓜	饮食/2烹饪/2中国烹饪/2八大菜系/粤菜
焖腐皮鸭	饮食/2烹饪/2中国烹饪/2八大菜系/粤菜
焖角玉肉	饮食/2烹饪/2中国烹饪/2八大菜系/粤菜
焖豆腐盒	饮食/2烹饪/2中国烹饪/2八大菜系/粤菜
焖酿鳝卷	饮食/2烹饪/2中国烹饪/2八大菜系/粤菜
焖金钱冬瓜	饮食/2烹饪/2中国烹饪/2八大菜系/粤菜
牡丹煎酿蛇脯	饮食/2烹饪/2中国烹饪/2八大菜系/粤菜
牡蛎蒸米饭	饮食/2烹饪/2中国烹饪/2八大菜系/粤菜
玫瑰手撕鸡	饮食/2烹饪/2中国烹饪/2八大菜系/粤菜
玫瑰露排骨	饮食/2烹饪/2中国烹饪/2八大菜系/粤菜
南乳扣肉	饮食/2烹饪/2中国烹饪/2八大菜系/粤菜
南乳白鳝球	饮食/2烹饪/2中国烹饪/2八大菜系/粤菜
南北杏、川贝炖鹧鸪	饮食/2烹饪/2中国烹饪/2八大菜系/粤菜
南北杏仁鹌鹑汤	饮食/2烹饪/2中国烹饪/2八大菜系/粤菜
南北杏川贝炖鹧鸪	饮食/2烹饪/2中国烹饪/2八大菜系/粤菜
南北杏海底椰生鱼汤	饮食/2烹饪/2中国烹饪/2八大菜系/粤菜
南海里水冬瓜	饮食/2烹饪/2中国烹饪/2八大菜系/粤菜
南瓜冰糖水	饮食/2烹饪/2中国烹饪/2八大菜系/粤菜
南瓜咕老虾	饮食/2烹饪/2中国烹饪/2八大菜系/粤菜
南瓜排骨	饮食/2烹饪/2中国烹饪/2八大菜系/粤菜
南瓜滚牛肉汤	饮食/2烹饪/2中国烹饪/2八大菜系/粤菜
南瓜炆鱼腩	饮食/2烹饪/2中国烹饪/2八大菜系/粤菜
南芪杜仲猪脊骨汤	饮食/2烹饪/2中国烹饪/2八大菜系/粤菜
南豆花淡竹叶猪展汤	饮食/2烹饪/2中国烹饪/2八大菜系/粤菜
奶味芦笋汤	饮食/2烹饪/2中国烹饪/2八大菜系/粤菜
奶汤面	饮食/2烹饪/2中国烹饪/2八大菜系/粤菜
奶鱼煮菜心	饮食/2烹饪/2中国烹饪/2八大菜系/粤菜
柠檬乳酪饼	饮食/2烹饪/2中国烹饪/2八大菜系/粤菜
柠汁炸软鸡	饮食/2烹饪/2中国烹饪/2八大菜系/粤菜
泥鳅黄芪猪瘦肉汤	饮食/2烹饪/2中国烹饪/2八大菜系/粤菜
牛佛烘肘	饮食/2烹饪/2中国烹饪/2八大菜系/粤菜
牛奶咸水鱼汤	饮食/2烹饪/2中国烹饪/2八大菜系/粤菜
牛奶椰子竹丝鸡汤	饮食/2烹饪/2中国烹饪/2八大菜系/粤菜
牛奶炖鸡汤	饮食/2烹饪/2中国烹饪/2八大菜系/粤菜
牛奶煮平菇	饮食/2烹饪/2中国烹饪/2八大菜系/粤菜
牛展汤	饮食/2烹饪/2中国烹饪/2八大菜系/粤菜
牛肉丸汤	饮食/2烹饪/2中国烹饪/2八大菜系/粤菜
牛蒡排骨汤	饮食/2烹饪/2中国烹饪/2八大菜系/粤菜
牛蒡沙拉	饮食/2烹饪/2中国烹饪/2八大菜系/粤菜
牛蒡泼蛋	饮食/2烹饪/2中国烹饪/2八大菜系/粤菜
牛蒡糕	饮食/2烹饪/2中国烹饪/2八大菜系/粤菜
牛蒡脆肠	饮食/2烹饪/2中国烹饪/2八大菜系/粤菜
牛蒡茶冻	饮食/2烹饪/2中国烹饪/2八大菜系/粤菜
牛蒡香羹	饮食/2烹饪/2中国烹饪/2八大菜系/粤菜
平都牛肉松	饮食/2烹饪/2中国烹饪/2八大菜系/粤菜
平锅猪肝焖饭	饮食/2烹饪/2中国烹饪/2八大菜系/粤菜
排骨蒸番薯	饮食/2烹饪/2中国烹饪/2八大菜系/粤菜
普宁豆酱骨	饮食/2烹饪/2中国烹饪/2八大菜系/粤菜
普宁豆酱鸡	饮食/2烹饪/2中国烹饪/2八大菜系/粤菜
泮塘马蹄糕	饮食/2烹饪/2中国烹饪/2八大菜系/粤菜
牌坊面	饮食/2烹饪/2中国烹饪/2八大菜系/粤菜
七彩什锦煲	饮食/2烹饪/2中国烹饪/2八大菜系/粤菜
七彩瓤猪肚	饮食/2烹饪/2中国烹饪/2八大菜系/粤菜
丘卫国	饮食/2烹饪/2中国烹饪/2八大菜系/粤菜
全家福豆腐	饮食/2烹饪/2中国烹饪/2八大菜系/粤菜
千岛汁鸡球	饮食/2烹饪/2中国烹饪/2八大菜系/粤菜
千斤拔杜仲煲猪尾	饮食/2烹饪/2中国烹饪/2八大菜系/粤菜
杞子南枣炖金钱龟汤	饮食/2烹饪/2中国烹饪/2八大菜系/粤菜
杞子巴戟山斑鱼汤	饮食/2烹饪/2中国烹饪/2八大菜系/粤菜
杞子桂圆海鱼汤	饮食/2烹饪/2中国烹饪/2八大菜系/粤菜
杞子淮山猪脑汤	饮食/2烹饪/2中国烹饪/2八大菜系/粤菜
杞子牛肝汤	饮食/2烹饪/2中国烹饪/2八大菜系/粤菜
棋子豆腐	饮食/2烹饪/2中国烹饪/2八大菜系/粤菜
泉水焖鲩鱼	饮食/2烹饪/2中国烹饪/2八大菜系/粤菜
浅色海鲜豉油	饮食/2烹饪/2中国烹饪/2八大菜系/粤菜
清干贝丸	饮食/2烹饪/2中国烹饪/2八大菜系/粤菜
清水煮名鸡	饮食/2烹饪/2中国烹饪/2八大菜系/粤菜
清江鱼茄子煲	饮食/2烹饪/2中国烹饪/2八大菜系/粤菜
清汤炸肚	饮食/2烹饪/2中国烹饪/2八大菜系/粤菜
清汤牛腩	饮食/2烹饪/2中国烹饪/2八大菜系/粤菜
清汤肚把	饮食/2烹饪/2中国烹饪/2八大菜系/粤菜
清汤银耳	饮食/2烹饪/2中国烹饪/2八大菜系/粤菜
清汤鳝把	饮食/2烹饪/2中国烹饪/2八大菜系/粤菜
清润养肺汤	饮食/2烹饪/2中国烹饪/2八大菜系/粤菜
清润红绿糖水	饮食/2烹饪/2中国烹饪/2八大菜系/粤菜
清炒河虾	饮食/2烹饪/2中国烹饪/2八大菜系/粤菜
清炒蚕豆	饮食/2烹饪/2中国烹饪/2八大菜系/粤菜
清炒鸭掌	饮食/2烹饪/2中国烹饪/2八大菜系/粤菜
清炖柠檬羊腩汤	饮食/2烹饪/2中国烹饪/2八大菜系/粤菜
清炖蚌肉	饮食/2烹饪/2中国烹饪/2八大菜系/粤菜
清焖凤爪	饮食/2烹饪/2中国烹饪/2八大菜系/粤菜
清真酱牛肉	饮食/2烹饪/2中国烹饪/2八大菜系/粤菜
清肠胃热汤	饮食/2烹饪/2中国烹饪/2八大菜系/粤菜
清蒸冬瓜汉堡	饮食/2烹饪/2中国烹饪/2八大菜系/粤菜
清蒸沙姜鸡	饮食/2烹饪/2中国烹饪/2八大菜系/粤菜
清蒸白鳝	饮食/2烹饪/2中国烹饪/2八大菜系/粤菜
清蒸石斑鱼	饮食/2烹饪/2中国烹饪/2八大菜系/粤菜
清蒸荷叶鱼	饮食/2烹饪/2中国烹饪/2八大菜系/粤菜
清蒸鲈鱼	饮食/2烹饪/2中国烹饪/2八大菜系/粤菜
清补凉乳鸽汤	饮食/2烹饪/2中国烹饪/2八大菜系/粤菜
清补凉煲莲子鱼尾汤	饮食/2烹饪/2中国烹饪/2八大菜系/粤菜
清补凉煲鸡脚汤	饮食/2烹饪/2中国烹饪/2八大菜系/粤菜
清补凉节瓜煲猪踭	饮食/2烹饪/2中国烹饪/2八大菜系/粤菜
清补羊肉汤	饮食/2烹饪/2中国烹饪/2八大菜系/粤菜
清醉竹笙	饮食/2烹饪/2中国烹饪/2八大菜系/粤菜
清醉草菰	饮食/2烹饪/2中国烹饪/2八大菜系/粤菜
清金鲤虾	饮食/2烹饪/2中国烹饪/2八大菜系/粤菜
清风送爽	饮食/2烹饪/2中国烹饪/2八大菜系/粤菜
炝油菜	饮食/2烹饪/2中国烹饪/2八大菜系/粤菜
炝羊肚青椒	饮食/2烹饪/2中国烹饪/2八大菜系/粤菜
乳酪蒸虾仁	饮食/2烹饪/2中国烹饪/2八大菜系/粤菜
乳鸽青菜汤	饮食/2烹饪/2中国烹饪/2八大菜系/粤菜
人参地黄炖蜜糖	饮食/2烹饪/2中国烹饪/2八大菜系/粤菜
人参天冬鲜鸡汤	饮食/2烹饪/2中国烹饪/2八大菜系/粤菜
人日生财汤	饮食/2烹饪/2中国烹饪/2八大菜系/粤菜
如意猪肉卷	饮食/2烹饪/2中国烹饪/2八大菜系/粤菜
润燥下火猪肺汤	饮食/2烹饪/2中国烹饪/2八大菜系/粤菜
润燥热咳饮	饮食/2烹饪/2中国烹饪/2八大菜系/粤菜
润燥黄豆肉排汤	饮食/2烹饪/2中国烹饪/2八大菜系/粤菜
润肺菜干汤	饮食/2烹饪/2中国烹饪/2八大菜系/粤菜
瓤木花雀	饮食/2烹饪/2中国烹饪/2八大菜系/粤菜
《三雪蚌花瘦肉汤》	饮食/2烹饪/2中国烹饪/2八大菜系/粤菜
《三鲜鱼唇》	饮食/2烹饪/2中国烹饪/2八大菜系/粤菜
《桑葚粥》	饮食/2烹饪/2中国烹饪/2八大菜系/粤菜
三丁烩虾仁	饮食/2烹饪/2中国烹饪/2八大菜系/粤菜
三丝拌糟鸡	饮食/2烹饪/2中国烹饪/2八大菜系/粤菜
三丝鱿鱼	饮食/2烹饪/2中国烹饪/2八大菜系/粤菜
三味玉翡翠	饮食/2烹饪/2中国烹饪/2八大菜系/粤菜
三子炖猪腰汤	饮食/2烹饪/2中国烹饪/2八大菜系/粤菜
三宝酱虾炒西洋菜	饮食/2烹饪/2中国烹饪/2八大菜系/粤菜
三才鲜鸡汤	饮食/2烹饪/2中国烹饪/2八大菜系/粤菜
三皮丝	饮食/2烹饪/2中国烹饪/2八大菜系/粤菜
三色杂烩粥	饮食/2烹饪/2中国烹饪/2八大菜系/粤菜
三色鸡丁	饮食/2烹饪/2中国烹饪/2八大菜系/粤菜
三色龙虾	饮食/2烹饪/2中国烹饪/2八大菜系/粤菜
三菇浸鱼云	饮食/2烹饪/2中国烹饪/2八大菜系/粤菜
三角豆腐饺	饮食/2烹饪/2中国烹饪/2八大菜系/粤菜
三雪蚌花瘦肉汤	饮食/2烹饪/2中国烹饪/2八大菜系/粤菜
三鲜锅巴	饮食/2烹饪/2中国烹饪/2八大菜系/粤菜
上料鱼圆	饮食/2烹饪/2中国烹饪/2八大菜系/粤菜
上汤奶白菜	饮食/2烹饪/2中国烹饪/2八大菜系/粤菜
上汤虾丸	饮食/2烹饪/2中国烹饪/2八大菜系/粤菜
上汤西兰花	饮食/2烹饪/2中国烹饪/2八大菜系/粤菜
上汤鱼饺	饮食/2烹饪/2中国烹饪/2八大菜系/粤菜
上汤龙虾面	饮食/2烹饪/2中国烹饪/2八大菜系/粤菜
丝瓜云耳滚肉片汤	饮食/2烹饪/2中国烹饪/2八大菜系/粤菜
丝瓜炖豆腐	饮食/2烹饪/2中国烹饪/2八大菜系/粤菜
丝瓜百合猪肝汤	饮食/2烹饪/2中国烹饪/2八大菜系/粤菜
丝瓜草菇滚鲮鱼球汤	饮食/2烹饪/2中国烹饪/2八大菜系/粤菜
丝瓜鲢鱼汤	饮食/2烹饪/2中国烹饪/2八大菜系/粤菜
事事平安	饮食/2烹饪/2中国烹饪/2八大菜系/粤菜
什锦冬瓜帽	饮食/2烹饪/2中国烹饪/2八大菜系/粤菜
什锦海参	饮食/2烹饪/2中国烹饪/2八大菜系/粤菜
什锦烩饭	饮食/2烹饪/2中国烹饪/2八大菜系/粤菜
什锦瓜盅	饮食/2烹饪/2中国烹饪/2八大菜系/粤菜
什锦蛋卷	饮食/2烹饪/2中国烹饪/2八大菜系/粤菜
什锦豆腐汤	饮食/2烹饪/2中国烹饪/2八大菜系/粤菜
什锦麦胚饼	饮食/2烹饪/2中国烹饪/2八大菜系/粤菜
双仁猪展汤	饮食/2烹饪/2中国烹饪/2八大菜系/粤菜
双杏蛤油	饮食/2烹饪/2中国烹饪/2八大菜系/粤菜
双腊萝卜饼	饮食/2烹饪/2中国烹饪/2八大菜系/粤菜
双鱼茄子	饮食/2烹饪/2中国烹饪/2八大菜系/粤菜
双黄会脆	饮食/2烹饪/2中国烹饪/2八大菜系/粤菜
四乌补益汤	饮食/2烹饪/2中国烹饪/2八大菜系/粤菜
四味山药膏	饮食/2烹饪/2中国烹饪/2八大菜系/粤菜
四喜黄豆粒	饮食/2烹饪/2中国烹饪/2八大菜系/粤菜
四宝上汤	饮食/2烹饪/2中国烹饪/2八大菜系/粤菜
四宝素菜包	饮食/2烹饪/2中国烹饪/2八大菜系/粤菜
四宝豆腐	饮食/2烹饪/2中国烹饪/2八大菜系/粤菜
山楂扁豆金银肾汤	饮食/2烹饪/2中国烹饪/2八大菜系/粤菜
山楂核桃茶	饮食/2烹饪/2中国烹饪/2八大菜系/粤菜
山楂草决明猪瘦肉汤	饮食/2烹饪/2中国烹饪/2八大菜系/粤菜
山甲田鸡片	饮食/2烹饪/2中国烹饪/2八大菜系/粤菜
山稔大芥菜汤	饮食/2烹饪/2中国烹饪/2八大菜系/粤菜
山药炒虾仁	饮食/2烹饪/2中国烹饪/2八大菜系/粤菜
山药煮豆腐	饮食/2烹饪/2中国烹饪/2八大菜系/粤菜
山药百合大枣粥	饮食/2烹饪/2中国烹饪/2八大菜系/粤菜
山药蒸鲫鱼	饮食/2烹饪/2中国烹饪/2八大菜系/粤菜
山药薏仁茯苓粳米粥	饮食/2烹饪/2中国烹饪/2八大菜系/粤菜
山药鲫鱼豆腐汤	饮食/2烹饪/2中国烹饪/2八大菜系/粤菜
山萸肉合桃乌鸡汤	饮食/2烹饪/2中国烹饪/2八大菜系/粤菜
山蓝猪瘦肉汤	饮食/2烹饪/2中国烹饪/2八大菜系/粤菜
时菜烩猪红	饮食/2烹饪/2中国烹饪/2八大菜系/粤菜
时菜牛肉球	饮食/2烹饪/2中国烹饪/2八大菜系/粤菜
松子仁猪展	饮食/2烹饪/2中国烹饪/2八大菜系/粤菜
松子仁西洋参鲜鸡汤	饮食/2烹饪/2中国烹饪/2八大菜系/粤菜
松子叉烧滑蛋	饮食/2烹饪/2中国烹饪/2八大菜系/粤菜
松子鱼块	饮食/2烹饪/2中国烹饪/2八大菜系/粤菜
松脆海蜇皮	饮食/2烹饪/2中国烹饪/2八大菜系/粤菜
松花蛋瘦肉生蚝粥	饮食/2烹饪/2中国烹饪/2八大菜系/粤菜
树花炖土鸡	饮食/2烹饪/2中国烹饪/2八大菜系/粤菜
桑叶杞子猪肝汤	饮食/2烹饪/2中国烹饪/2八大菜系/粤菜
桑叶茅根白豆煲猪展	饮食/2烹饪/2中国烹饪/2八大菜系/粤菜
桑杏炖猪肺	饮食/2烹饪/2中国烹饪/2八大菜系/粤菜
桑椹子薏米白鸽汤	饮食/2烹饪/2中国烹饪/2八大菜系/粤菜
桑葚粥	饮食/2烹饪/2中国烹饪/2八大菜系/粤菜
桑螵蛸煲猪小肚汤	饮食/2烹饪/2中国烹饪/2八大菜系/粤菜
水晶扣肉	饮食/2烹饪/2中国烹饪/2八大菜系/粤菜
水晶明虾球	饮食/2烹饪/2中国烹饪/2八大菜系/粤菜
水晶蟹粉卷	饮食/2烹饪/2中国烹饪/2八大菜系/粤菜
水瓜滚大眼鱼汤	饮食/2烹饪/2中国烹饪/2八大菜系/粤菜
沙丁鱼烙	饮食/2烹饪/2中国烹饪/2八大菜系/粤菜
沙参玉竹猪皮汤	饮食/2烹饪/2中国烹饪/2八大菜系/粤菜
沙参玉竹老鸭汤	饮食/2烹饪/2中国烹饪/2八大菜系/粤菜
沙嗲酱芥兰	饮食/2烹饪/2中国烹饪/2八大菜系/粤菜
沙拉海鲜饺	饮食/2烹饪/2中国烹饪/2八大菜系/粤菜
沙拉蛋	饮食/2烹饪/2中国烹饪/2八大菜系/粤菜
沙拉酱炒鱿鱼卷	饮食/2烹饪/2中国烹饪/2八大菜系/粤菜
沙田柚肉无花果猪展汤	饮食/2烹饪/2中国烹饪/2八大菜系/粤菜
沙田柚花猪肚汤	饮食/2烹饪/2中国烹饪/2八大菜系/粤菜
沙窝海鲜粥	饮食/2烹饪/2中国烹饪/2八大菜系/粤菜
沙苑子鱼胶汤	饮食/2烹饪/2中国烹饪/2八大菜系/粤菜
沙茶炒鸡丝	饮食/2烹饪/2中国烹饪/2八大菜系/粤菜
沙茶牛肉	饮食/2烹饪/2中国烹饪/2八大菜系/粤菜
沙茶牛肉炒芥蓝	饮食/2烹饪/2中国烹饪/2八大菜系/粤菜
沙茶牛蒡	饮食/2烹饪/2中国烹饪/2八大菜系/粤菜
深圳市新相约宾馆	饮食/2烹饪/2中国烹饪/2八大菜系/粤菜
深圳新全盛海鲜酒楼	饮食/2烹饪/2中国烹饪/2八大菜系/粤菜
深圳盐田海鲜街	饮食/2烹饪/2中国烹饪/2八大菜系/粤菜
湿热肝炎马齿苋汤	饮食/2烹饪/2中国烹饪/2八大菜系/粤菜
烧凤眼肝	饮食/2烹饪/2中国烹饪/2八大菜系/粤菜
烧大肠白鳝	饮食/2烹饪/2中国烹饪/2八大菜系/粤菜
烧桂花肠	饮食/2烹饪/2中国烹饪/2八大菜系/粤菜
烧汁煎生蚝	饮食/2烹饪/2中国烹饪/2八大菜系/粤菜
烧汁蛇丝豆腐	饮食/2烹饪/2中国烹饪/2八大菜系/粤菜
烧瓤鲜沙虫	饮食/2烹饪/2中国烹饪/2八大菜系/粤菜
烧石岐乳鸽	饮食/2烹饪/2中国烹饪/2八大菜系/粤菜
烧禾虫	饮食/2烹饪/2中国烹饪/2八大菜系/粤菜
烧肉藏珠	饮食/2烹饪/2中国烹饪/2八大菜系/粤菜
生嗜鸡块	饮食/2烹饪/2中国烹饪/2八大菜系/粤菜
生地冬瓜鲍鱼汤	饮食/2烹饪/2中国烹饪/2八大菜系/粤菜
生地天冬猪肝汤	饮食/2烹饪/2中国烹饪/2八大菜系/粤菜
生地木棉花瘦肉汤	饮食/2烹饪/2中国烹饪/2八大菜系/粤菜
生地绿豆猪大肠汤	饮食/2烹饪/2中国烹饪/2八大菜系/粤菜
生姜槟榔水	饮食/2烹饪/2中国烹饪/2八大菜系/粤菜
生姜滚芥菜汤	饮食/2烹饪/2中国烹饪/2八大菜系/粤菜
生炊麒麟鱼	饮食/2烹饪/2中国烹饪/2八大菜系/粤菜
生炊龙虾	饮食/2烹饪/2中国烹饪/2八大菜系/粤菜
生炒墨鱼	饮食/2烹饪/2中国烹饪/2八大菜系/粤菜
生炒腰花	饮食/2烹饪/2中国烹饪/2八大菜系/粤菜
生炒虾松	饮食/2烹饪/2中国烹饪/2八大菜系/粤菜
生炒鱼片	饮食/2烹饪/2中国烹饪/2八大菜系/粤菜
生炒鱼面	饮食/2烹饪/2中国烹饪/2八大菜系/粤菜
生炒鸡球	饮食/2烹饪/2中国烹饪/2八大菜系/粤菜
生炒鸡米	饮食/2烹饪/2中国烹饪/2八大菜系/粤菜
生炒鸡蓬	饮食/2烹饪/2中国烹饪/2八大菜系/粤菜
生焖狗肉	饮食/2烹饪/2中国烹饪/2八大菜系/粤菜
生莲乌石	饮食/2烹饪/2中国烹饪/2八大菜系/粤菜
生莲瓜盅	饮食/2烹饪/2中国烹饪/2八大菜系/粤菜
生菜鱼米包	饮食/2烹饪/2中国烹饪/2八大菜系/粤菜
生蘑菇花生猪扁骨汤	饮食/2烹饪/2中国烹饪/2八大菜系/粤菜
生鱼葛菜汤	饮食/2烹饪/2中国烹饪/2八大菜系/粤菜
瘦肉汁炖虫草	饮食/2烹饪/2中国烹饪/2八大菜系/粤菜
兔肉炖鸡脚	饮食/2烹饪/2中国烹饪/2八大菜系/粤菜
土茯苓芡实瘦肉汤	饮食/2烹饪/2中国烹饪/2八大菜系/粤菜
土豆焖鸡块	饮食/2烹饪/2中国烹饪/2八大菜系/粤菜
土豆焖鸭	饮食/2烹饪/2中国烹饪/2八大菜系/粤菜
土豆罐焖鸡	饮食/2烹饪/2中国烹饪/2八大菜系/粤菜
土豆西红柿煲排骨	饮食/2烹饪/2中国烹饪/2八大菜系/粤菜
天麻鲍鱼汤	饮食/2烹饪/2中国烹饪/2八大菜系/粤菜
太史五蛇羹	饮食/2烹饪/2中国烹饪/2八大菜系/粤菜
太子参百合田鸡汤	饮食/2烹饪/2中国烹饪/2八大菜系/粤菜
太子参石斛瘦肉汤	饮食/2烹饪/2中国烹饪/2八大菜系/粤菜
太极山楂奶露	饮食/2烹饪/2中国烹饪/2八大菜系/粤菜
太极芋泥	饮食/2烹饪/2中国烹饪/2八大菜系/粤菜
太极马啼	饮食/2烹饪/2中国烹饪/2八大菜系/粤菜
太爷鸡	饮食/2烹饪/2中国烹饪/2八大菜系/粤菜
桃仁饮	饮食/2烹饪/2中国烹饪/2八大菜系/粤菜
桃米炒蛋	饮食/2烹饪/2中国烹饪/2八大菜系/粤菜
汤泡猪肚尖	饮食/2烹饪/2中国烹饪/2八大菜系/粤菜
汤煎镶带子	饮食/2烹饪/2中国烹饪/2八大菜系/粤菜
甜冬瓜泥	饮食/2烹饪/2中国烹饪/2八大菜系/粤菜
甜姜薯丸	饮食/2烹饪/2中国烹饪/2八大菜系/粤菜
甜姜豆腐	饮食/2烹饪/2中国烹饪/2八大菜系/粤菜
甜栗子泥	饮食/2烹饪/2中国烹饪/2八大菜系/粤菜
甜椒滚潺菜汤	饮食/2烹饪/2中国烹饪/2八大菜系/粤菜
甜秋瓜烙	饮食/2烹饪/2中国烹饪/2八大菜系/粤菜
甜绉纱肉	饮食/2烹饪/2中国烹饪/2八大菜系/粤菜
甜花生汤	饮食/2烹饪/2中国烹饪/2八大菜系/粤菜
甜酸海蜇	饮食/2烹饪/2中国烹饪/2八大菜系/粤菜
田七薤白鸡肉汤	饮食/2烹饪/2中国烹饪/2八大菜系/粤菜
田七鹿脚筋水鸭汤	饮食/2烹饪/2中国烹饪/2八大菜系/粤菜
田园汤	饮食/2烹饪/2中国烹饪/2八大菜系/粤菜
田鸡饭煲	饮食/2烹饪/2中国烹饪/2八大菜系/粤菜
乌发仙人粥	饮食/2烹饪/2中国烹饪/2八大菜系/粤菜
乌骨鸡归黄汤	饮食/2烹饪/2中国烹饪/2八大菜系/粤菜
五子毛桃煲鸡	饮食/2烹饪/2中国烹饪/2八大菜系/粤菜
五彩小炒	饮食/2烹饪/2中国烹饪/2八大菜系/粤菜
五彩炒蛇丝	饮食/2烹饪/2中国烹饪/2八大菜系/粤菜
五彩炒鲍鱼	饮食/2烹饪/2中国烹饪/2八大菜系/粤菜
五彩焗鱼	饮食/2烹饪/2中国烹饪/2八大菜系/粤菜
五彩牛肉丝	饮食/2烹饪/2中国烹饪/2八大菜系/粤菜
五彩猪肠粉	饮食/2烹饪/2中国烹饪/2八大菜系/粤菜
五彩鱼蛋	饮食/2烹饪/2中国烹饪/2八大菜系/粤菜
五心花卷饭	饮食/2烹饪/2中国烹饪/2八大菜系/粤菜
五果糯羹	饮食/2烹饪/2中国烹饪/2八大菜系/粤菜
五果鲜	饮食/2烹饪/2中国烹饪/2八大菜系/粤菜
五柳料	饮食/2烹饪/2中国烹饪/2八大菜系/粤菜
五神饮	饮食/2烹饪/2中国烹饪/2八大菜系/粤菜
五通桥月糕	饮食/2烹饪/2中国烹饪/2八大菜系/粤菜
五香辣猪手	饮食/2烹饪/2中国烹饪/2八大菜系/粤菜
午餐三明治	饮食/2烹饪/2中国烹饪/2八大菜系/粤菜
无花果南杏排骨汤	饮食/2烹饪/2中国烹饪/2八大菜系/粤菜
无花果炖瘦肉	饮食/2烹饪/2中国烹饪/2八大菜系/粤菜
无花果炖瘦肉汤	饮食/2烹饪/2中国烹饪/2八大菜系/粤菜
无花果章鱼干鲫鱼汤	饮食/2烹饪/2中国烹饪/2八大菜系/粤菜
无花果茶树菇山鸡汤	饮食/2烹饪/2中国烹饪/2八大菜系/粤菜
瓦缶焗蟹	饮食/2烹饪/2中国烹饪/2八大菜系/粤菜
XO酱爆扇贝王	饮食/2烹饪/2中国烹饪/2八大菜系/粤菜
下火大芥菜咸鱼头汤	饮食/2烹饪/2中国烹饪/2八大菜系/粤菜
新粤西楼纸包鸡风味烤	饮食/2烹饪/2中国烹饪/2八大菜系/粤菜
咸柠檬老鸭汤	饮食/2烹饪/2中国烹饪/2八大菜系/粤菜
咸猪骨芥菜煲	饮食/2烹饪/2中国烹饪/2八大菜系/粤菜
咸蛋瘦肉滚节瓜汤	饮食/2烹饪/2中国烹饪/2八大菜系/粤菜
咸蛋节瓜鱼尾汤	饮食/2烹饪/2中国烹饪/2八大菜系/粤菜
咸蛋蒸肉饼	饮食/2烹饪/2中国烹饪/2八大菜系/粤菜
咸酸菜滚猪红汤	饮食/2烹饪/2中国烹饪/2八大菜系/粤菜
咸酸菜滚黄沙大蚬	饮食/2烹饪/2中国烹饪/2八大菜系/粤菜
咸酸菜蚝豉干煲猪踭	饮食/2烹饪/2中国烹饪/2八大菜系/粤菜
咸酸菜蚝豉干瘦肉汤	饮食/2烹饪/2中国烹饪/2八大菜系/粤菜
咸鱼鸡粒煮豆腐	饮食/2烹饪/2中国烹饪/2八大菜系/粤菜
夏暑清烦汤	饮食/2烹饪/2中国烹饪/2八大菜系/粤菜
夏枯草菊花猪踭汤	饮食/2烹饪/2中国烹饪/2八大菜系/粤菜
夏枯草黄豆煲猪横脷汤	饮食/2烹饪/2中国烹饪/2八大菜系/粤菜
小南瓜排骨盅	饮食/2烹饪/2中国烹饪/2八大菜系/粤菜
小塘菜滚鲩鱼尾汤	饮食/2烹饪/2中国烹饪/2八大菜系/粤菜
小煎仔鸡	饮食/2烹饪/2中国烹饪/2八大菜系/粤菜
新兴牛肉丸	饮食/2烹饪/2中国烹饪/2八大菜系/粤菜
新式菠萝咕咾肉	饮食/2烹饪/2中国烹饪/2八大菜系/粤菜
新潮三丝消暑汤	饮食/2烹饪/2中国烹饪/2八大菜系/粤菜
新鲜木瓜南北杏炖雪耳	饮食/2烹饪/2中国烹饪/2八大菜系/粤菜
新鲜霸王花猪踭汤	饮食/2烹饪/2中国烹饪/2八大菜系/粤菜
杏仁夏日沙拉	饮食/2烹饪/2中国烹饪/2八大菜系/粤菜
杏仁橄榄配法式面包	饮食/2烹饪/2中国烹饪/2八大菜系/粤菜
杏仁白肺	饮食/2烹饪/2中国烹饪/2八大菜系/粤菜
杏仁草莓奶昔	饮食/2烹饪/2中国烹饪/2八大菜系/粤菜
杏仁豆腐	饮食/2烹饪/2中国烹饪/2八大菜系/粤菜
杏仁鱼鳃	饮食/2烹饪/2中国烹饪/2八大菜系/粤菜
杏圆炖甲鱼	饮食/2烹饪/2中国烹饪/2八大菜系/粤菜
杏片香虾筒	饮食/2烹饪/2中国烹饪/2八大菜系/粤菜
消暑五豆汤	饮食/2烹饪/2中国烹饪/2八大菜系/粤菜
消暑海蜇马蹄汤	饮食/2烹饪/2中国烹饪/2八大菜系/粤菜
湘江鲫鱼	饮食/2烹饪/2中国烹饪/2八大菜系/粤菜
现代粤菜烹调技术	饮食/2烹饪/2中国烹饪/2八大菜系/粤菜
云耳沙榄炖猪展	饮食/2烹饪/2中国烹饪/2八大菜系/粤菜
云耳沙榄炖猪搌	饮食/2烹饪/2中国烹饪/2八大菜系/粤菜
云腿护国菜	饮食/2烹饪/2中国烹饪/2八大菜系/粤菜
云腿虾茸荚	饮食/2烹饪/2中国烹饪/2八大菜系/粤菜
云苓党参扇骨炖龟汤	饮食/2烹饪/2中国烹饪/2八大菜系/粤菜
云苓簕苋菜头鲫鱼汤	饮食/2烹饪/2中国烹饪/2八大菜系/粤菜
云苓黄精生蚝汤	饮食/2烹饪/2中国烹饪/2八大菜系/粤菜
元宝牛蒡	饮食/2烹饪/2中国烹饪/2八大菜系/粤菜
印度咖喱焖羊腩	饮食/2烹饪/2中国烹饪/2八大菜系/粤菜
原盅炖北菇	饮食/2烹饪/2中国烹饪/2八大菜系/粤菜
原盅瓜丸	饮食/2烹饪/2中国烹饪/2八大菜系/粤菜
圆白菜炒腊肉	饮食/2烹饪/2中国烹饪/2八大菜系/粤菜
圆肉杞子炖鲍鱼	饮食/2烹饪/2中国烹饪/2八大菜系/粤菜
圆肉花生排骨汤	饮食/2烹饪/2中国烹饪/2八大菜系/粤菜
夜香冬瓜盅	饮食/2烹饪/2中国烹饪/2八大菜系/粤菜
夜香花滚猪润汤	饮食/2烹饪/2中国烹饪/2八大菜系/粤菜
意式杏仁脆饼	饮食/2烹饪/2中国烹饪/2八大菜系/粤菜
月影明珠	饮食/2烹饪/2中国烹饪/2八大菜系/粤菜
杨桃雪梨牛展汤	饮食/2烹饪/2中国烹饪/2八大菜系/粤菜
柚子肉炖鲜鸡汤	饮食/2烹饪/2中国烹饪/2八大菜系/粤菜
柚皮蒸排骨	饮食/2烹饪/2中国烹饪/2八大菜系/粤菜
柚皮鲶鱼盅	饮食/2烹饪/2中国烹饪/2八大菜系/粤菜
椰子水晶鸡	饮食/2烹饪/2中国烹饪/2八大菜系/粤菜
椰子马铃薯牛肉汤	饮食/2烹饪/2中国烹饪/2八大菜系/粤菜
椰子黄豆无花果田鸡汤	饮食/2烹饪/2中国烹饪/2八大菜系/粤菜
椰盅海皇	饮食/2烹饪/2中国烹饪/2八大菜系/粤菜
椰菜烟肉汤	饮食/2烹饪/2中国烹饪/2八大菜系/粤菜
椰香红豆糕	饮食/2烹饪/2中国烹饪/2八大菜系/粤菜
油泡桂鱼球	饮食/2烹饪/2中国烹饪/2八大菜系/粤菜
油泡螺球	饮食/2烹饪/2中国烹饪/2八大菜系/粤菜
油泡鱼册	饮食/2烹饪/2中国烹饪/2八大菜系/粤菜
油泡鱼青丸	饮食/2烹饪/2中国烹饪/2八大菜系/粤菜
油泡鲜鱿	饮食/2烹饪/2中国烹饪/2八大菜系/粤菜
油泡鳝鱼	饮食/2烹饪/2中国烹饪/2八大菜系/粤菜
油浸鲳鱼	饮食/2烹饪/2中国烹饪/2八大菜系/粤菜
油淋苦瓜	饮食/2烹饪/2中国烹饪/2八大菜系/粤菜
油淋鸡	饮食/2烹饪/2中国烹饪/2八大菜系/粤菜
油焖竹笋	饮食/2烹饪/2中国烹饪/2八大菜系/粤菜
油爆带子	饮食/2烹饪/2中国烹饪/2八大菜系/粤菜
油豆腐镶肉	饮食/2烹饪/2中国烹饪/2八大菜系/粤菜
洋参雪耳炖燕窝	饮食/2烹饪/2中国烹饪/2八大菜系/粤菜
洋葱炒墨鱼仔	饮食/2烹饪/2中国烹饪/2八大菜系/粤菜
游龙戏凤煲	饮食/2烹饪/2中国烹饪/2八大菜系/粤菜
烟筒白菜	饮食/2烹饪/2中国烹饪/2八大菜系/粤菜
燕窝乳鸽汤	饮食/2烹饪/2中国烹饪/2八大菜系/粤菜
燕窝炖雪梨	饮食/2烹饪/2中国烹饪/2八大菜系/粤菜
燕窝芋蓉	饮食/2烹饪/2中国烹饪/2八大菜系/粤菜
燕窝鸭心汤	饮食/2烹饪/2中国烹饪/2八大菜系/粤菜
玉带油皇果	饮食/2烹饪/2中国烹饪/2八大菜系/粤菜
玉枕白菜	饮食/2烹饪/2中国烹饪/2八大菜系/粤菜
玉树麒麟生鱼	饮食/2烹饪/2中国烹饪/2八大菜系/粤菜
玉竹沙参鹧鸪汤	饮食/2烹饪/2中国烹饪/2八大菜系/粤菜
玉竹炖鹧鸪	饮食/2烹饪/2中国烹饪/2八大菜系/粤菜
玉竹百合猪瘦肉汤	饮食/2烹饪/2中国烹饪/2八大菜系/粤菜
玉米猪尾汤	饮食/2烹饪/2中国烹饪/2八大菜系/粤菜
玉米羹	饮食/2烹饪/2中国烹饪/2八大菜系/粤菜
玉米须猪小肚汤	饮食/2烹饪/2中国烹饪/2八大菜系/粤菜
玉须泥鳅汤	饮食/2烹饪/2中国烹饪/2八大菜系/粤菜
中药八宝鲜鸡汤	饮食/2烹饪/2中国烹饪/2八大菜系/粤菜
子孙满堂	饮食/2烹饪/2中国烹饪/2八大菜系/粤菜
子萝卜汤	饮食/2烹饪/2中国烹饪/2八大菜系/粤菜
总汇沙拉	饮食/2烹饪/2中国烹饪/2八大菜系/粤菜
招财进宝	饮食/2烹饪/2中国烹饪/2八大菜系/粤菜
支竹羊腩煲	饮食/2烹饪/2中国烹饪/2八大菜系/粤菜
杂豆小麦粥	饮食/2烹饪/2中国烹饪/2八大菜系/粤菜
柱侯酱凤爪	饮食/2烹饪/2中国烹饪/2八大菜系/粤菜
柱侯酱手抓骨	饮食/2烹饪/2中国烹饪/2八大菜系/粤菜
柱候鸡	饮食/2烹饪/2中国烹饪/2八大菜系/粤菜
植物扒四宝	饮食/2烹饪/2中国烹饪/2八大菜系/粤菜
植物添银花	饮食/2烹饪/2中国烹饪/2八大菜系/粤菜
汁青口卷	饮食/2烹饪/2中国烹饪/2八大菜系/粤菜
湛江鸡	饮食/2烹饪/2中国烹饪/2八大菜系/粤菜
炸八卦鸡	饮食/2烹饪/2中国烹饪/2八大菜系/粤菜
炸八块	饮食/2烹饪/2中国烹饪/2八大菜系/粤菜
炸吉利排骨	饮食/2烹饪/2中国烹饪/2八大菜系/粤菜
炸姜薯卷	饮食/2烹饪/2中国烹饪/2八大菜系/粤菜
炸子鸡	饮食/2烹饪/2中国烹饪/2八大菜系/粤菜
炸旗斗鸭	饮食/2烹饪/2中国烹饪/2八大菜系/粤菜
炸来不及	饮食/2烹饪/2中国烹饪/2八大菜系/粤菜
炸烹鲈鱼腩	饮食/2烹饪/2中国烹饪/2八大菜系/粤菜
炸珍珠鸡翼	饮食/2烹饪/2中国烹饪/2八大菜系/粤菜
炸网油鱼	饮食/2烹饪/2中国烹饪/2八大菜系/粤菜
炸芙蓉肉	饮食/2烹饪/2中国烹饪/2八大菜系/粤菜
炸荷包鱼	饮食/2烹饪/2中国烹饪/2八大菜系/粤菜
炸荷包鲜鱿	饮食/2烹饪/2中国烹饪/2八大菜系/粤菜
炸蟹肉鲜奶	饮食/2烹饪/2中国烹饪/2八大菜系/粤菜
炸豆腐鱼	饮食/2烹饪/2中国烹饪/2八大菜系/粤菜
炸金钗蟹	饮食/2烹饪/2中国烹饪/2八大菜系/粤菜
炸金钱鸭	饮食/2烹饪/2中国烹饪/2八大菜系/粤菜
炸高丽肉	饮食/2烹饪/2中国烹饪/2八大菜系/粤菜
炸龙肠	饮食/2烹饪/2中国烹饪/2八大菜系/粤菜
猪仔薯红萝卜排骨汤	饮食/2烹饪/2中国烹饪/2八大菜系/粤菜
猪笼草赤小豆猪横脷汤	饮食/2烹饪/2中国烹饪/2八大菜系/粤菜
猪肚包鸡	饮食/2烹饪/2中国烹饪/2八大菜系/粤菜
猪肚黄芪汤	饮食/2烹饪/2中国烹饪/2八大菜系/粤菜
猪肝枸杞子汤	饮食/2烹饪/2中国烹饪/2八大菜系/粤菜
猪肝瘦肉丝瓜汤	饮食/2烹饪/2中国烹饪/2八大菜系/粤菜
猪肝绿豆粥	饮食/2烹饪/2中国烹饪/2八大菜系/粤菜
猪肝菠菜汤	饮食/2烹饪/2中国烹饪/2八大菜系/粤菜
猪脾枣米粥	饮食/2烹饪/2中国烹饪/2八大菜系/粤菜
猪蹄葱白炖豆腐	饮食/2烹饪/2中国烹饪/2八大菜系/粤菜
珍珠南瓜	饮食/2烹饪/2中国烹饪/2八大菜系/粤菜
珍珠鲤鱼	饮食/2烹饪/2中国烹饪/2八大菜系/粤菜
珠瓜炒鱼片	饮食/2烹饪/2中国烹饪/2八大菜系/粤菜
阿一炒翅	饮食/2烹饪/2中国烹饪/2八大菜系/湘菜
冰糖湘莲	饮食/2烹饪/2中国烹饪/2八大菜系/湘菜
北芪炖乳鸽	饮食/2烹饪/2中国烹饪/2八大菜系/湘菜
北菇扒双蔬	饮食/2烹饪/2中国烹饪/2八大菜系/湘菜
北葱焖羊肉	饮食/2烹饪/2中国烹饪/2八大菜系/湘菜
布袋饼	饮食/2烹饪/2中国烹饪/2八大菜系/湘菜
拔丝湘白莲	饮食/2烹饪/2中国烹饪/2八大菜系/湘菜
板栗冰糖粥	饮食/2烹饪/2中国烹饪/2八大菜系/湘菜
爆炒空心菜	饮食/2烹饪/2中国烹饪/2八大菜系/湘菜
玻璃鲜墨	饮食/2烹饪/2中国烹饪/2八大菜系/湘菜
白云猪手(猪蹄)	饮食/2烹饪/2中国烹饪/2八大菜系/湘菜
白灼明螺	饮食/2烹饪/2中国烹饪/2八大菜系/湘菜
白灼虾	饮食/2烹饪/2中国烹饪/2八大菜系/湘菜
白焯明螺	饮食/2烹饪/2中国烹饪/2八大菜系/湘菜
白菜牛百叶汤	饮食/2烹饪/2中国烹饪/2八大菜系/湘菜
白辣椒炒肉	饮食/2烹饪/2中国烹饪/2八大菜系/湘菜
百合炒肉片	饮食/2烹饪/2中国烹饪/2八大菜系/湘菜
百花大虾面	饮食/2烹饪/2中国烹饪/2八大菜系/湘菜
百花煎凤翼	饮食/2烹饪/2中国烹饪/2八大菜系/湘菜
百花辽参	饮食/2烹饪/2中国烹饪/2八大菜系/湘菜
碧绿豆腐盏	饮食/2烹饪/2中国烹饪/2八大菜系/湘菜
碧绿韭菜饺	饮食/2烹饪/2中国烹饪/2八大菜系/湘菜
背篓人家	饮食/2烹饪/2中国烹饪/2八大菜系/湘菜
荸荠西米羹	饮食/2烹饪/2中国烹饪/2八大菜系/湘菜
菠菜鸡煲	饮食/2烹饪/2中国烹饪/2八大菜系/湘菜
菠萝炒牛肉	饮食/2烹饪/2中国烹饪/2八大菜系/湘菜
菠萝苦瓜煲鲜鸡	饮食/2烹饪/2中国烹饪/2八大菜系/湘菜
菠萝虾球	饮食/2烹饪/2中国烹饪/2八大菜系/湘菜
补密制豆腐乳	饮食/2烹饪/2中国烹饪/2八大菜系/湘菜
避风塘炒蟹	饮食/2烹饪/2中国烹饪/2八大菜系/湘菜
霸王鸡翼	饮食/2烹饪/2中国烹饪/2八大菜系/湘菜
鲍汁扒百灵菇	饮食/2烹饪/2中国烹饪/2八大菜系/湘菜
鲍翅木瓜船	饮食/2烹饪/2中国烹饪/2八大菜系/湘菜
鲍鱼三丝粥	饮食/2烹饪/2中国烹饪/2八大菜系/湘菜
鲍鱼鸡粒饺	饮食/2烹饪/2中国烹饪/2八大菜系/湘菜
霸王肘子	饮食/2烹饪/2中国烹饪/2八大菜系/湘菜
白汁八宝鱼脯	饮食/2烹饪/2中国烹饪/2八大菜系/湘菜
宝塔黄鳝	饮食/2烹饪/2中国烹饪/2八大菜系/湘菜
白辣椒	饮食/2烹饪/2中国烹饪/2八大菜系/湘菜
冰糖玉米羹	饮食/2烹饪/2中国烹饪/2八大菜系/湘菜
板栗烧白菜心	饮食/2烹饪/2中国烹饪/2八大菜系/湘菜
冰糖三元	饮食/2烹饪/2中国烹饪/2八大菜系/湘菜
冲菜	饮食/2烹饪/2中国烹饪/2八大菜系/湘菜
聪厨	饮食/2烹饪/2中国烹饪/2八大菜系/湘菜
叉烧肉便当	饮食/2烹饪/2中国烹饪/2八大菜系/湘菜
川椒蟹	饮食/2烹饪/2中国烹饪/2八大菜系/湘菜
柴鱼贵妃粥	饮食/2烹饪/2中国烹饪/2八大菜系/湘菜
橙汁豆腐	饮食/2烹饪/2中国烹饪/2八大菜系/湘菜
潮州炒姜饭	饮食/2烹饪/2中国烹饪/2八大菜系/湘菜
潮州肉冻	饮食/2烹饪/2中国烹饪/2八大菜系/湘菜
潮汕鱼丸	饮食/2烹饪/2中国烹饪/2八大菜系/湘菜
潮洲蒸粉果	饮食/2烹饪/2中国烹饪/2八大菜系/湘菜
炒大明虾	饮食/2烹饪/2中国烹饪/2八大菜系/湘菜
炒芙蓉蟹	饮食/2烹饪/2中国烹饪/2八大菜系/湘菜
炒香螺	饮食/2烹饪/2中国烹饪/2八大菜系/湘菜
翠竹粉蒸鮰鱼	饮食/2烹饪/2中国烹饪/2八大菜系/湘菜
翠竹粉蒸鱼	饮食/2烹饪/2中国烹饪/2八大菜系/湘菜
脆皮鲜果球	饮食/2烹饪/2中国烹饪/2八大菜系/湘菜
脆皮鸡(广式）	饮食/2烹饪/2中国烹饪/2八大菜系/湘菜
葱椒鸡	饮食/2烹饪/2中国烹饪/2八大菜系/湘菜
葱油鸡便当	饮食/2烹饪/2中国烹饪/2八大菜系/湘菜
豉椒墨鱼球	饮食/2烹饪/2中国烹饪/2八大菜系/湘菜
豉汁蒸盘龙鳝	饮食/2烹饪/2中国烹饪/2八大菜系/湘菜
豉汁蒸鱼片	饮食/2烹饪/2中国烹饪/2八大菜系/湘菜
赤豆糯米饭	饮食/2烹饪/2中国烹饪/2八大菜系/湘菜
醋煲青蟹	饮食/2烹饪/2中国烹饪/2八大菜系/湘菜
醋血鸭	饮食/2烹饪/2中国烹饪/2八大菜系/湘菜
长沙美食网	饮食/2烹饪/2中国烹饪/2八大菜系/湘菜
陈皮牛肉饼	饮食/2烹饪/2中国烹饪/2八大菜系/湘菜
厨留香	饮食/2烹饪/2中国烹饪/2八大菜系/湘菜
豉椒炒小卷	饮食/2烹饪/2中国烹饪/2八大菜系/湘菜
莼菜玻璃鸡片汤	饮食/2烹饪/2中国烹饪/2八大菜系/湘菜
朝珠虎皮凤掌	饮食/2烹饪/2中国烹饪/2八大菜系/湘菜
彩虹鱼丁	饮食/2烹饪/2中国烹饪/2八大菜系/湘菜
莼菜虾扇	饮食/2烹饪/2中国烹饪/2八大菜系/湘菜
吃湘喝辣	饮食/2烹饪/2中国烹饪/2八大菜系/湘菜
东安鸡	饮食/2烹饪/2中国烹饪/2八大菜系/湘菜
东江盐H鸡	饮食/2烹饪/2中国烹饪/2八大菜系/湘菜
东江盐浸鸡	饮食/2烹饪/2中国烹饪/2八大菜系/湘菜
东江豆腐煲	饮食/2烹饪/2中国烹饪/2八大菜系/湘菜
冬瓜煲汤	饮食/2烹饪/2中国烹饪/2八大菜系/湘菜
冬笋炒牛肉	饮食/2烹饪/2中国烹饪/2八大菜系/湘菜
冬菇蒸滑鸡	饮食/2烹饪/2中国烹饪/2八大菜系/湘菜
剁椒鱼头	饮食/2烹饪/2中国烹饪/2八大菜系/湘菜
大碗厨教您做遍拿手好	饮食/2烹饪/2中国烹饪/2八大菜系/湘菜
大良炒鲜奶	饮食/2烹饪/2中国烹饪/2八大菜系/湘菜
大蒜煮萝卜	饮食/2烹饪/2中国烹饪/2八大菜系/湘菜
大蒜野鸭汤	饮食/2烹饪/2中国烹饪/2八大菜系/湘菜
洞庭金龟	饮食/2烹饪/2中国烹饪/2八大菜系/湘菜
淡菜蒸鸭块	饮食/2烹饪/2中国烹饪/2八大菜系/湘菜
炖柠檬鸭	饮食/2烹饪/2中国烹饪/2八大菜系/湘菜
蛋黄千层糕	饮食/2烹饪/2中国烹饪/2八大菜系/湘菜
豆腐圆	饮食/2烹饪/2中国烹饪/2八大菜系/湘菜
豆腐自制法	饮食/2烹饪/2中国烹饪/2八大菜系/湘菜
豆荚炒腊肉	饮食/2烹饪/2中国烹饪/2八大菜系/湘菜
豆酱焖牛腩	饮食/2烹饪/2中国烹饪/2八大菜系/湘菜
豆酱焗鹌鹑	饮食/2烹饪/2中国烹饪/2八大菜系/湘菜
带皮牛肉	饮食/2烹饪/2中国烹饪/2八大菜系/湘菜
豆瓣酱烧肥鱼	饮食/2烹饪/2中国烹饪/2八大菜系/湘菜
大围山蒸方肉	饮食/2烹饪/2中国烹饪/2八大菜系/湘菜
剁椒鱼头豆腐	饮食/2烹饪/2中国烹饪/2八大菜系/湘菜
二参玉竹瘦肉汤	饮食/2烹饪/2中国烹饪/2八大菜系/湘菜
凤尾大虾	饮食/2烹饪/2中国烹饪/2八大菜系/湘菜
发丝百叶	饮食/2烹饪/2中国烹饪/2八大菜系/湘菜
发菜扒大鸭	饮食/2烹饪/2中国烹饪/2八大菜系/湘菜
发菜火腩焖蚝豉	饮食/2烹饪/2中国烹饪/2八大菜系/湘菜
番茄盖浇饭	饮食/2烹饪/2中国烹饪/2八大菜系/湘菜
福州干面	饮食/2烹饪/2中国烹饪/2八大菜系/湘菜
福建炒饭	饮食/2烹饪/2中国烹饪/2八大菜系/湘菜
粉皮拌鸡丝	饮食/2烹饪/2中国烹饪/2八大菜系/湘菜
翡翠鲜虾饺	饮食/2烹饪/2中国烹饪/2八大菜系/湘菜
腐卤薄片冬笋	饮食/2烹饪/2中国烹饪/2八大菜系/湘菜
芙蓉鲫鱼	饮食/2烹饪/2中国烹饪/2八大菜系/湘菜
风味腊肠卷	饮食/2烹饪/2中国烹饪/2八大菜系/湘菜
风情羊柳	饮食/2烹饪/2中国烹饪/2八大菜系/湘菜
粉蒸竹筒鱼	饮食/2烹饪/2中国烹饪/2八大菜系/湘菜
福禄双脆	饮食/2烹饪/2中国烹饪/2八大菜系/湘菜
咕咾肉便当	饮食/2烹饪/2中国烹饪/2八大菜系/湘菜
咕咾肉烩饭	饮食/2烹饪/2中国烹饪/2八大菜系/湘菜
咕噜牛排	饮食/2烹饪/2中国烹饪/2八大菜系/湘菜
官渡唆螺	饮食/2烹饪/2中国烹饪/2八大菜系/湘菜
干炸肝花	饮食/2烹饪/2中国烹饪/2八大菜系/湘菜
干炸蟹枣	饮食/2烹饪/2中国烹饪/2八大菜系/湘菜
干烧凤翼翅	饮食/2烹饪/2中国烹饪/2八大菜系/湘菜
干煎虾碌	饮食/2烹饪/2中国烹饪/2八大菜系/湘菜
干锅一品菇	饮食/2烹饪/2中国烹饪/2八大菜系/湘菜
干锅手撕包菜	饮食/2烹饪/2中国烹饪/2八大菜系/湘菜
干锅腊味河蚌	饮食/2烹饪/2中国烹饪/2八大菜系/湘菜
广东油鸡	饮食/2烹饪/2中国烹饪/2八大菜系/湘菜
广东油鸡淋酱	饮食/2烹饪/2中国烹饪/2八大菜系/湘菜
广东泡菜	饮食/2烹饪/2中国烹饪/2八大菜系/湘菜
广东烧腊饭	饮食/2烹饪/2中国烹饪/2八大菜系/湘菜
广东烩饭	饮食/2烹饪/2中国烹饪/2八大菜系/湘菜
广东盐鸡	饮食/2烹饪/2中国烹饪/2八大菜系/湘菜
广东粉果	饮食/2烹饪/2中国烹饪/2八大菜系/湘菜
广东虾饺	饮食/2烹饪/2中国烹饪/2八大菜系/湘菜
广州市佬湘楼饮食有限	饮食/2烹饪/2中国烹饪/2八大菜系/湘菜
广州炒饭	饮食/2烹饪/2中国烹饪/2八大菜系/湘菜
广式回锅肉	饮食/2烹饪/2中国烹饪/2八大菜系/湘菜
广式滷鸭翅	饮食/2烹饪/2中国烹饪/2八大菜系/湘菜
广式香炒面	饮食/2烹饪/2中国烹饪/2八大菜系/湘菜
怪味鲜鱿鱼	饮食/2烹饪/2中国烹饪/2八大菜系/湘菜
果汁肉脯	饮食/2烹饪/2中国烹饪/2八大菜系/湘菜
桂鱼三味	饮食/2烹饪/2中国烹饪/2八大菜系/湘菜
港式糯米饭	饮食/2烹饪/2中国烹饪/2八大菜系/湘菜
港式糯米饭 咕噜牛排	饮食/2烹饪/2中国烹饪/2八大菜系/湘菜
甘柠芝麻虾	饮食/2烹饪/2中国烹饪/2八大菜系/湘菜
羔烧羊肉	饮食/2烹饪/2中国烹饪/2八大菜系/湘菜
莞爆牛百叶	饮食/2烹饪/2中国烹饪/2八大菜系/湘菜
蛤仔猪肚汤	饮食/2烹饪/2中国烹饪/2八大菜系/湘菜
贵妃酱牛肚	饮食/2烹饪/2中国烹饪/2八大菜系/湘菜
贵妃醋鸡钵	饮食/2烹饪/2中国烹饪/2八大菜系/湘菜
锅烧野鸡片	饮食/2烹饪/2中国烹饪/2八大菜系/湘菜
锅贴鱼	饮食/2烹饪/2中国烹饪/2八大菜系/湘菜
干锅鸡胗	饮食/2烹饪/2中国烹饪/2八大菜系/湘菜
干锅菊花牛鞭	饮食/2烹饪/2中国烹饪/2八大菜系/湘菜
锅巴鱿鱼片	饮食/2烹饪/2中国烹饪/2八大菜系/湘菜
桂花盐水鸭	饮食/2烹饪/2中国烹饪/2八大菜系/湘菜
干锅牛头肉	饮食/2烹饪/2中国烹饪/2八大菜系/湘菜
好丝百叶	饮食/2烹饪/2中国烹饪/2八大菜系/湘菜
徽菜三色蒸蛋	饮食/2烹饪/2中国烹饪/2八大菜系/湘菜
核桃马来糕	饮食/2烹饪/2中国烹饪/2八大菜系/湘菜
洪江鸭	饮食/2烹饪/2中国烹饪/2八大菜系/湘菜
海参盆蒸	饮食/2烹饪/2中国烹饪/2八大菜系/湘菜
海棠冬菇	饮食/2烹饪/2中国烹饪/2八大菜系/湘菜
湖南徐记酒店管理有限	饮食/2烹饪/2中国烹饪/2八大菜系/湘菜
湖南泡子姜	饮食/2烹饪/2中国烹饪/2八大菜系/湘菜
湖南紫油姜	饮食/2烹饪/2中国烹饪/2八大菜系/湘菜
火焰醉虾	饮食/2烹饪/2中国烹饪/2八大菜系/湘菜
火腿炒茄瓜	饮食/2烹饪/2中国烹饪/2八大菜系/湘菜
火腿穿凤翅	饮食/2烹饪/2中国烹饪/2八大菜系/湘菜
猴菇花枝饺	饮食/2烹饪/2中国烹饪/2八大菜系/湘菜
红烧大群翅	饮食/2烹饪/2中国烹饪/2八大菜系/湘菜
红烧大鲍翅	饮食/2烹饪/2中国烹饪/2八大菜系/湘菜
红烧米豆腐	饮食/2烹饪/2中国烹饪/2八大菜系/湘菜
红烧鱼皮	饮食/2烹饪/2中国烹饪/2八大菜系/湘菜
红烧鳝片	饮食/2烹饪/2中国烹饪/2八大菜系/湘菜
红焖明皮	饮食/2烹饪/2中国烹饪/2八大菜系/湘菜
红焖海参	饮食/2烹饪/2中国烹饪/2八大菜系/湘菜
红煨君山金龟	饮食/2烹饪/2中国烹饪/2八大菜系/湘菜
红煨牛肉	饮食/2烹饪/2中国烹饪/2八大菜系/湘菜
红糟猪肉汤	饮食/2烹饪/2中国烹饪/2八大菜系/湘菜
红绕驴肉	饮食/2烹饪/2中国烹饪/2八大菜系/湘菜
花枝玉米饼	饮食/2烹饪/2中国烹饪/2八大菜系/湘菜
花生酱糯米糍	饮食/2烹饪/2中国烹饪/2八大菜系/湘菜
花边合子	饮食/2烹饪/2中国烹饪/2八大菜系/湘菜
花雕鸡	饮食/2烹饪/2中国烹饪/2八大菜系/湘菜
荤素丝塔	饮食/2烹饪/2中国烹饪/2八大菜系/湘菜
荷叶米粉鸡	饮食/2烹饪/2中国烹饪/2八大菜系/湘菜
荷香蒸田鸡	饮食/2烹饪/2中国烹饪/2八大菜系/湘菜
蚝油炒芥兰	饮食/2烹饪/2中国烹饪/2八大菜系/湘菜
蚝油鲜竹卷	饮食/2烹饪/2中国烹饪/2八大菜系/湘菜
蚝皇凤爪	饮食/2烹饪/2中国烹饪/2八大菜系/湘菜
韩式豆腐泡菜炒猪肉	饮食/2烹饪/2中国烹饪/2八大菜系/湘菜
黄惠明	饮食/2烹饪/2中国烹饪/2八大菜系/湘菜
黄耳鱼片汤	饮食/2烹饪/2中国烹饪/2八大菜系/湘菜
黄豆酱炒酿鸡髀菇	饮食/2烹饪/2中国烹饪/2八大菜系/湘菜
黄金咖哩角	饮食/2烹饪/2中国烹饪/2八大菜系/湘菜
黄金马蹄条	饮食/2烹饪/2中国烹饪/2八大菜系/湘菜
黄鸭叫	饮食/2烹饪/2中国烹饪/2八大菜系/湘菜
洪江甜酱	饮食/2烹饪/2中国烹饪/2八大菜系/湘菜
红煨带皮牛肉	饮食/2烹饪/2中国烹饪/2八大菜系/湘菜
海鲜水果锅巴	饮食/2烹饪/2中国烹饪/2八大菜系/湘菜
红煨鱼唇	饮食/2烹饪/2中国烹饪/2八大菜系/湘菜
烩鸭舌掌	饮食/2烹饪/2中国烹饪/2八大菜系/湘菜
海蜇肉片	饮食/2烹饪/2中国烹饪/2八大菜系/湘菜
红油凉粉条	饮食/2烹饪/2中国烹饪/2八大菜系/湘菜
红烧义河蚶	饮食/2烹饪/2中国烹饪/2八大菜系/湘菜
红油莲藕片	饮食/2烹饪/2中国烹饪/2八大菜系/湘菜
九味油汁鸡	饮食/2烹饪/2中国烹饪/2八大菜系/湘菜
京酱芥兰菜	饮食/2烹饪/2中国烹饪/2八大菜系/湘菜
君山银针鱼片	饮食/2烹饪/2中国烹饪/2八大菜系/湘菜
姜葱炒蟹	饮食/2烹饪/2中国烹饪/2八大菜系/湘菜
家乡豆腐	饮食/2烹饪/2中国烹饪/2八大菜系/湘菜
家鄉鹹水餃	饮食/2烹饪/2中国烹饪/2八大菜系/湘菜
椒盐爆中虾	饮食/2烹饪/2中国烹饪/2八大菜系/湘菜
椒盐芋头丸	饮食/2烹饪/2中国烹饪/2八大菜系/湘菜
焦香辣椒	饮食/2烹饪/2中国烹饪/2八大菜系/湘菜
煎虱目鱼	饮食/2烹饪/2中国烹饪/2八大菜系/湘菜
煎连壳蟹	饮食/2烹饪/2中国烹饪/2八大菜系/湘菜
煎鲳鱼	饮食/2烹饪/2中国烹饪/2八大菜系/湘菜
爵士奶皇包	饮食/2烹饪/2中国烹饪/2八大菜系/湘菜
聚广源	饮食/2烹饪/2中国烹饪/2八大菜系/湘菜
芥末薄肉片	饮食/2烹饪/2中国烹饪/2八大菜系/湘菜
菊花素海参	饮食/2烹饪/2中国烹饪/2八大菜系/湘菜
菊花青鱼	饮食/2烹饪/2中国烹饪/2八大菜系/湘菜
菌油煎鱼饼	饮食/2烹饪/2中国烹饪/2八大菜系/湘菜
酱油萝卜皮	饮食/2烹饪/2中国烹饪/2八大菜系/湘菜
金丝虾球	饮食/2烹饪/2中国烹饪/2八大菜系/湘菜
金华玉树鸡	饮食/2烹饪/2中国烹饪/2八大菜系/湘菜
金牌叉烧酥	饮食/2烹饪/2中国烹饪/2八大菜系/湘菜
金牌猪手王	饮食/2烹饪/2中国烹饪/2八大菜系/湘菜
金银蒜蒸丝瓜	饮食/2烹饪/2中国烹饪/2八大菜系/湘菜
金鱼戏莲	饮食/2烹饪/2中国烹饪/2八大菜系/湘菜
韭黄炸春卷	饮食/2烹饪/2中国烹饪/2八大菜系/湘菜
鸡丝干丝	饮食/2烹饪/2中国烹饪/2八大菜系/湘菜
鸡条豆包卷	饮食/2烹饪/2中国烹饪/2八大菜系/湘菜
家常炒菜	饮食/2烹饪/2中国烹饪/2八大菜系/湘菜
九味金钱鲜贝	饮食/2烹饪/2中国烹饪/2八大菜系/湘菜
鸡汁玉翠鱼丸	饮食/2烹饪/2中国烹饪/2八大菜系/湘菜
九味贵妃鸡	饮食/2烹饪/2中国烹饪/2八大菜系/湘菜
焦炸肉带饼	饮食/2烹饪/2中国烹饪/2八大菜系/湘菜
九味烹茄子	饮食/2烹饪/2中国烹饪/2八大菜系/湘菜
九味牛百叶	饮食/2烹饪/2中国烹饪/2八大菜系/湘菜
芥兰腊肉	饮食/2烹饪/2中国烹饪/2八大菜系/湘菜
尖椒炒肉	饮食/2烹饪/2中国烹饪/2八大菜系/湘菜
芥末薄片肉	饮食/2烹饪/2中国烹饪/2八大菜系/湘菜
口味蛇	饮食/2烹饪/2中国烹饪/2八大菜系/湘菜
开封牛肉干	饮食/2烹饪/2中国烹饪/2八大菜系/湘菜
开屏柴把桂鱼	饮食/2烹饪/2中国烹饪/2八大菜系/湘菜
开屏柴把脆肚	饮食/2烹饪/2中国烹饪/2八大菜系/湘菜
开胃水鱼	饮食/2烹饪/2中国烹饪/2八大菜系/湘菜
烤广式三层肉	饮食/2烹饪/2中国烹饪/2八大菜系/湘菜
烤香酥鸡	饮食/2烹饪/2中国烹饪/2八大菜系/湘菜
苦瓜镶肉	饮食/2烹饪/2中国烹饪/2八大菜系/湘菜
葵花虾饼	饮食/2烹饪/2中国烹饪/2八大菜系/湘菜
口蘑子面筋	饮食/2烹饪/2中国烹饪/2八大菜系/湘菜
兰花八宝冬瓜	饮食/2烹饪/2中国烹饪/2八大菜系/湘菜
凉拌橘子鸭	饮食/2烹饪/2中国烹饪/2八大菜系/湘菜
拉糟鱼块	饮食/2烹饪/2中国烹饪/2八大菜系/湘菜
浏阳蒸菜	饮食/2烹饪/2中国烹饪/2八大菜系/湘菜
浪花天香鱼	饮食/2烹饪/2中国烹饪/2八大菜系/湘菜
淋酸红椒	饮食/2烹饪/2中国烹饪/2八大菜系/湘菜
篱飘香翅	饮食/2烹饪/2中国烹饪/2八大菜系/湘菜
老妈子带鱼	饮食/2烹饪/2中国烹饪/2八大菜系/湘菜
腊味合蒸	饮食/2烹饪/2中国烹饪/2八大菜系/湘菜
腊味拌饭	饮食/2烹饪/2中国烹饪/2八大菜系/湘菜
腊味煲仔饭	饮食/2烹饪/2中国烹饪/2八大菜系/湘菜
腊味芋头糕	饮食/2烹饪/2中国烹饪/2八大菜系/湘菜
腊味萝蔔糕(2)	饮食/2烹饪/2中国烹饪/2八大菜系/湘菜
腊肉饭	饮食/2烹饪/2中国烹饪/2八大菜系/湘菜
荔枝虾球	饮食/2烹饪/2中国烹饪/2八大菜系/湘菜
萝蔔丝酥饼	饮食/2烹饪/2中国烹饪/2八大菜系/湘菜
辣椒炒海参	饮食/2烹饪/2中国烹饪/2八大菜系/湘菜
辣椒炒猪肚片	饮食/2烹饪/2中国烹饪/2八大菜系/湘菜
辣椒炒肚片	饮食/2烹饪/2中国烹饪/2八大菜系/湘菜
辣椒鱼	饮食/2烹饪/2中国烹饪/2八大菜系/湘菜
辣白菜炒鸡块	饮食/2烹饪/2中国烹饪/2八大菜系/湘菜
辣椒炒肉	饮食/2烹饪/2中国烹饪/2八大菜系/湘菜
鲮鱼烩芽白	饮食/2烹饪/2中国烹饪/2八大菜系/湘菜
龙须燕丸	饮食/2烹饪/2中国烹饪/2八大菜系/湘菜
连锅羊肉	饮食/2烹饪/2中国烹饪/2八大菜系/湘菜
兰花大虾	饮食/2烹饪/2中国烹饪/2八大菜系/湘菜
密制烤河鳗	饮食/2烹饪/2中国烹饪/2八大菜系/湘菜
木桶辣子虾	饮食/2烹饪/2中国烹饪/2八大菜系/湘菜
毛式烧肉	饮食/2烹饪/2中国烹饪/2八大菜系/湘菜
美极基围虾	饮食/2烹饪/2中国烹饪/2八大菜系/湘菜
蜜桃沙丹虾	饮食/2烹饪/2中国烹饪/2八大菜系/湘菜
马铃薯笋焖鸡	饮食/2烹饪/2中国烹饪/2八大菜系/湘菜
麻仁香酥鸡	饮食/2烹饪/2中国烹饪/2八大菜系/湘菜
麻辣子鸡	饮食/2烹饪/2中国烹饪/2八大菜系/湘菜
麻辣狗肉	饮食/2烹饪/2中国烹饪/2八大菜系/湘菜
麻香湘莲露	饮食/2烹饪/2中国烹饪/2八大菜系/湘菜
麻辣猪脚	饮食/2烹饪/2中国烹饪/2八大菜系/湘菜
麻辣野兔丁	饮食/2烹饪/2中国烹饪/2八大菜系/湘菜
蜜汁枸杞腰果	饮食/2烹饪/2中国烹饪/2八大菜系/湘菜
南荠草莓饼	饮食/2烹饪/2中国烹饪/2八大菜系/湘菜
奶汤玉结鱼皮	饮食/2烹饪/2中国烹饪/2八大菜系/湘菜
奶汤竹荪鲍鱼	饮食/2烹饪/2中国烹饪/2八大菜系/湘菜
奶油烤白菜	饮食/2烹饪/2中国烹饪/2八大菜系/湘菜
柠檬鸡	饮食/2烹饪/2中国烹饪/2八大菜系/湘菜
泥鳅炖丝瓜	饮食/2烹饪/2中国烹饪/2八大菜系/湘菜
牛肉滑肠粉	饮食/2烹饪/2中国烹饪/2八大菜系/湘菜
牛肉炒面	饮食/2烹饪/2中国烹饪/2八大菜系/湘菜
牛肉菜心	饮食/2烹饪/2中国烹饪/2八大菜系/湘菜
奶汤生蹄筋	饮食/2烹饪/2中国烹饪/2八大菜系/湘菜
农家一碗香	饮食/2烹饪/2中国烹饪/2八大菜系/湘菜
彭家羊柳	饮食/2烹饪/2中国烹饪/2八大菜系/湘菜
泮塘马蹄糕	饮食/2烹饪/2中国烹饪/2八大菜系/湘菜
琵琶嫩豆腐	饮食/2烹饪/2中国烹饪/2八大菜系/湘菜
皮片乳猪	饮食/2烹饪/2中国烹饪/2八大菜系/湘菜
苹果鸡翅	饮食/2烹饪/2中国烹饪/2八大菜系/湘菜
彭家豆腐	饮食/2烹饪/2中国烹饪/2八大菜系/湘菜
清汤柴把鸭	饮食/2烹饪/2中国烹饪/2八大菜系/湘菜
清汤虾球鲍鱼	饮食/2烹饪/2中国烹饪/2八大菜系/湘菜
清汤鲍鱼丸	饮食/2烹饪/2中国烹饪/2八大菜系/湘菜
清炒河虾	饮食/2烹饪/2中国烹饪/2八大菜系/湘菜
清炖蛇龟鸡	饮食/2烹饪/2中国烹饪/2八大菜系/湘菜
清炖鸭架汤	饮食/2烹饪/2中国烹饪/2八大菜系/湘菜
清蒸白玉	饮食/2烹饪/2中国烹饪/2八大菜系/湘菜
祁阳鱼鲊	饮食/2烹饪/2中国烹饪/2八大菜系/湘菜
青椒剔骨肉	饮食/2烹饪/2中国烹饪/2八大菜系/湘菜
青椒榨菜牛柳盖浇饭	饮食/2烹饪/2中国烹饪/2八大菜系/湘菜
青椒炒豆角	饮食/2烹饪/2中国烹饪/2八大菜系/湘菜
青椒牛肉炒饭	饮食/2烹饪/2中国烹饪/2八大菜系/湘菜
青韭鱿鱼丝	饮食/2烹饪/2中国烹饪/2八大菜系/湘菜
鹊桥庆相逢	饮食/2烹饪/2中国烹饪/2八大菜系/湘菜
麒麟鲈鱼	饮食/2烹饪/2中国烹饪/2八大菜系/湘菜
黔味大虾	饮食/2烹饪/2中国烹饪/2八大菜系/湘菜
清炒南瓜藤	饮食/2烹饪/2中国烹饪/2八大菜系/湘菜
茄汁菠萝鱼	饮食/2烹饪/2中国烹饪/2八大菜系/湘菜
茄汁虎皮素卷	饮食/2烹饪/2中国烹饪/2八大菜系/湘菜
青椒炒削骨肉	饮食/2烹饪/2中国烹饪/2八大菜系/湘菜
青豆炒虾仁	饮食/2烹饪/2中国烹饪/2八大菜系/湘菜
鳅鱼蒸腊肉	饮食/2烹饪/2中国烹饪/2八大菜系/湘菜
鳅鱼附豆腐汤	饮食/2烹饪/2中国烹饪/2八大菜系/湘菜
清蒸烧鸭块	饮食/2烹饪/2中国烹饪/2八大菜系/湘菜
乳燕归巢	饮食/2烹饪/2中国烹饪/2八大菜系/湘菜
热带杂果酸奶沙拉	饮食/2烹饪/2中国烹饪/2八大菜系/湘菜
肉丝海带汤	饮食/2烹饪/2中国烹饪/2八大菜系/湘菜
肉排豆腐煲	饮食/2烹饪/2中国烹饪/2八大菜系/湘菜
软炸玉翠里脊卷	饮食/2烹饪/2中国烹饪/2八大菜系/湘菜
软酥猪腰	饮食/2烹饪/2中国烹饪/2八大菜系/湘菜
软酥鸡翅肫	饮食/2烹饪/2中国烹饪/2八大菜系/湘菜
什锦海参	饮食/2烹饪/2中国烹饪/2八大菜系/湘菜
双色年糕甜汤	饮食/2烹饪/2中国烹饪/2八大菜系/湘菜
双鱼茄子	饮食/2烹饪/2中国烹饪/2八大菜系/湘菜
四宝豆腐	饮食/2烹饪/2中国烹饪/2八大菜系/湘菜
四川冲菜	饮食/2烹饪/2中国烹饪/2八大菜系/湘菜
时菜牛肉球	饮食/2烹饪/2中国烹饪/2八大菜系/湘菜
松子金杯虾松	饮食/2烹饪/2中国烹饪/2八大菜系/湘菜
松子鱼块	饮食/2烹饪/2中国烹饪/2八大菜系/湘菜
水晶豆腐塔	饮食/2烹饪/2中国烹饪/2八大菜系/湘菜
水晶鸭块	饮食/2烹饪/2中国烹饪/2八大菜系/湘菜
水煮猪杂	饮食/2烹饪/2中国烹饪/2八大菜系/湘菜
沙拉海鲜饺	饮食/2烹饪/2中国烹饪/2八大菜系/湘菜
烧石岐乳鸽	饮食/2烹饪/2中国烹饪/2八大菜系/湘菜
烧禾虫	饮食/2烹饪/2中国烹饪/2八大菜系/湘菜
烧辣椒皮蛋	饮食/2烹饪/2中国烹饪/2八大菜系/湘菜
生炒腰花	饮食/2烹饪/2中国烹饪/2八大菜系/湘菜
生焖狗肉	饮食/2烹饪/2中国烹饪/2八大菜系/湘菜
石门肥肠煲	饮食/2烹饪/2中国烹饪/2八大菜系/湘菜
碎米蒸茄瓜	饮食/2烹饪/2中国烹饪/2八大菜系/湘菜
舒心驻颜老火汤	饮食/2烹饪/2中国烹饪/2八大菜系/湘菜
蒜子瑶柱脯	饮食/2烹饪/2中国烹饪/2八大菜系/湘菜
蒜泥鲜蚵	饮食/2烹饪/2中国烹饪/2八大菜系/湘菜
蒜白猪耳	饮食/2烹饪/2中国烹饪/2八大菜系/湘菜
蒜茸蜗鱼嘴	饮食/2烹饪/2中国烹饪/2八大菜系/湘菜
蒜香牛肋排	饮食/2烹饪/2中国烹饪/2八大菜系/湘菜
赛鲍鱼	饮食/2烹饪/2中国烹饪/2八大菜系/湘菜
酥炸明虾	饮食/2烹饪/2中国烹饪/2八大菜系/湘菜
酥炸禾花雀	饮食/2烹饪/2中国烹饪/2八大菜系/湘菜
酸菜煮鳝鱼	饮食/2烹饪/2中国烹饪/2八大菜系/湘菜
酸菜蒸大肠	饮食/2烹饪/2中国烹饪/2八大菜系/湘菜
酸辣狗肉	饮食/2烹饪/2中国烹饪/2八大菜系/湘菜
酸辣肘子	饮食/2烹饪/2中国烹饪/2八大菜系/湘菜
酸辣鸡丁	饮食/2烹饪/2中国烹饪/2八大菜系/湘菜
双味鳜鱼卷	饮食/2烹饪/2中国烹饪/2八大菜系/湘菜
酸辣墨鱼	饮食/2烹饪/2中国烹饪/2八大菜系/湘菜
蒜苗腊肉	饮食/2烹饪/2中国烹饪/2八大菜系/湘菜
酸萝卜炒脆骨	饮食/2烹饪/2中国烹饪/2八大菜系/湘菜
三元绣球干贝	饮食/2烹饪/2中国烹饪/2八大菜系/湘菜
烧大肥肠	饮食/2烹饪/2中国烹饪/2八大菜系/湘菜
什锦西米羹	饮食/2烹饪/2中国烹饪/2八大菜系/湘菜
水煮回头鱼	饮食/2烹饪/2中国烹饪/2八大菜系/湘菜
沙锅冬苋菜梗	饮食/2烹饪/2中国烹饪/2八大菜系/湘菜
水果鸡	饮食/2烹饪/2中国烹饪/2八大菜系/湘菜
太爷鸡	饮食/2烹饪/2中国烹饪/2八大菜系/湘菜
汤煎镶带子	饮食/2烹饪/2中国烹饪/2八大菜系/湘菜
糖醋酱	饮食/2烹饪/2中国烹饪/2八大菜系/湘菜
通大海杞子羹	饮食/2烹饪/2中国烹饪/2八大菜系/湘菜
铁板牛柳	饮食/2烹饪/2中国烹饪/2八大菜系/湘菜
糖醋熘里脊	饮食/2烹饪/2中国烹饪/2八大菜系/湘菜
糖霜桃仁	饮食/2烹饪/2中国烹饪/2八大菜系/湘菜
田螺鸡软骨	饮食/2烹饪/2中国烹饪/2八大菜系/湘菜
铁板干葱百花火焗鱼头	饮食/2烹饪/2中国烹饪/2八大菜系/湘菜
五元蒸鸽	饮食/2烹饪/2中国烹饪/2八大菜系/湘菜
五果鲜	饮食/2烹饪/2中国烹饪/2八大菜系/湘菜
五香焦肉	饮食/2烹饪/2中国烹饪/2八大菜系/湘菜
五香牛杂	饮食/2烹饪/2中国烹饪/2八大菜系/湘菜
乌龙山狗肉	饮食/2烹饪/2中国烹饪/2八大菜系/湘菜
五花肉酱拌豆腐	饮食/2烹饪/2中国烹饪/2八大菜系/湘菜
新长福	饮食/2烹饪/2中国烹饪/2八大菜系/湘菜
杏圆炖甲鱼	饮食/2烹饪/2中国烹饪/2八大菜系/湘菜
杏片香虾筒	饮食/2烹饪/2中国烹饪/2八大菜系/湘菜
湘乐汇	饮食/2烹饪/2中国烹饪/2八大菜系/湘菜
湘厦人湘菜酒楼	饮食/2烹饪/2中国烹饪/2八大菜系/湘菜
湘味口水鸡	饮食/2烹饪/2中国烹饪/2八大菜系/湘菜
湘味酸菜	饮食/2烹饪/2中国烹饪/2八大菜系/湘菜
湘式腊牛肉	饮食/2烹饪/2中国烹饪/2八大菜系/湘菜
湘江鲫鱼	饮食/2烹饪/2中国烹饪/2八大菜系/湘菜
湘菜地三鲜	饮食/2烹饪/2中国烹饪/2八大菜系/湘菜
湘菜王	饮食/2烹饪/2中国烹饪/2八大菜系/湘菜
潇湘猪手	饮食/2烹饪/2中国烹饪/2八大菜系/湘菜
虾仁蒸烧卖	饮食/2烹饪/2中国烹饪/2八大菜系/湘菜
虾蓉蛋卷	饮食/2烹饪/2中国烹饪/2八大菜系/湘菜
蟹黄晶烧卖	饮食/2烹饪/2中国烹饪/2八大菜系/湘菜
蠔油炒芥蘭	饮食/2烹饪/2中国烹饪/2八大菜系/湘菜
西柠煎软鸡	饮食/2烹饪/2中国烹饪/2八大菜系/湘菜
西洋参红花田鸡煲	饮食/2烹饪/2中国烹饪/2八大菜系/湘菜
西芹柠檬鸡	饮食/2烹饪/2中国烹饪/2八大菜系/湘菜
雪菜黄花鱼滚汤	饮食/2烹饪/2中国烹饪/2八大菜系/湘菜
香叶包子鸡	饮食/2烹饪/2中国烹饪/2八大菜系/湘菜
香椿煎鸡蛋	饮食/2烹饪/2中国烹饪/2八大菜系/湘菜
香炸桂鱼	饮食/2烹饪/2中国烹饪/2八大菜系/湘菜
香炸螺丝卷	饮食/2烹饪/2中国烹饪/2八大菜系/湘菜
香煎抱盐鱼	饮食/2烹饪/2中国烹饪/2八大菜系/湘菜
香煎莲藕饼	饮食/2烹饪/2中国烹饪/2八大菜系/湘菜
香煎韭菜饼	饮食/2烹饪/2中国烹饪/2八大菜系/湘菜
香芒冻奶酪	饮食/2烹饪/2中国烹饪/2八大菜系/湘菜
鲜虾琼山豆腐	饮食/2烹饪/2中国烹饪/2八大菜系/湘菜
鲜虾腐皮卷	饮食/2烹饪/2中国烹饪/2八大菜系/湘菜
湘	饮食/2烹饪/2中国烹饪/2八大菜系/湘菜
湘村馆	饮食/2烹饪/2中国烹饪/2八大菜系/湘菜
小炒腊牛肉	饮食/2烹饪/2中国烹饪/2八大菜系/湘菜
湘腊肉炒豆干	饮食/2烹饪/2中国烹饪/2八大菜系/湘菜
湘味酱板鸭	饮食/2烹饪/2中国烹饪/2八大菜系/湘菜
新长福餐饮管理有限公	饮食/2烹饪/2中国烹饪/2八大菜系/湘菜
香茅爆牛肉	饮食/2烹饪/2中国烹饪/2八大菜系/湘菜
香卤鸭掌	饮食/2烹饪/2中国烹饪/2八大菜系/湘菜
香煎鲳鱼	饮食/2烹饪/2中国烹饪/2八大菜系/湘菜
香辣泥鳅王	饮食/2烹饪/2中国烹饪/2八大菜系/湘菜
云南小瓜炒肥	饮食/2烹饪/2中国烹饪/2八大菜系/湘菜
原汁武陵水鱼	饮食/2烹饪/2中国烹饪/2八大菜系/湘菜
原蒸五元甲鱼	饮食/2烹饪/2中国烹饪/2八大菜系/湘菜
攸县香干	饮食/2烹饪/2中国烹饪/2八大菜系/湘菜
攸县香干炒肉	饮食/2烹饪/2中国烹饪/2八大菜系/湘菜
月影明珠	饮食/2烹饪/2中国烹饪/2八大菜系/湘菜
杨桥麸子肉	饮食/2烹饪/2中国烹饪/2八大菜系/湘菜
椰香红豆糕	饮食/2烹饪/2中国烹饪/2八大菜系/湘菜
油切饼	饮食/2烹饪/2中国烹饪/2八大菜系/湘菜
油炸臭豆腐	饮食/2烹饪/2中国烹饪/2八大菜系/湘菜
油焖火焙鱼	饮食/2烹饪/2中国烹饪/2八大菜系/湘菜
油爆带子	饮食/2烹饪/2中国烹饪/2八大菜系/湘菜
油辣佛手笋	饮食/2烹饪/2中国烹饪/2八大菜系/湘菜
油辣包菜卷	饮食/2烹饪/2中国烹饪/2八大菜系/湘菜
油酥火焙鱼	饮食/2烹饪/2中国烹饪/2八大菜系/湘菜
洋葱炒墨鱼仔	饮食/2烹饪/2中国烹饪/2八大菜系/湘菜
玉带油皇果	饮食/2烹饪/2中国烹饪/2八大菜系/湘菜
玉须泥鳅汤	饮食/2烹饪/2中国烹饪/2八大菜系/湘菜
瑶池老腊肉	饮食/2烹饪/2中国烹饪/2八大菜系/湘菜
野胡葱炒腊肉	饮食/2烹饪/2中国烹饪/2八大菜系/湘菜
银芽炒银芽	饮食/2烹饪/2中国烹饪/2八大菜系/湘菜
银针鸡汁鱼片	饮食/2烹饪/2中国烹饪/2八大菜系/湘菜
鱼丸火锅	饮食/2烹饪/2中国烹饪/2八大菜系/湘菜
鱼翅水晶包	饮食/2烹饪/2中国烹饪/2八大菜系/湘菜
鱼翅羹	饮食/2烹饪/2中国烹饪/2八大菜系/湘菜
鱼香豆腐	饮食/2烹饪/2中国烹饪/2八大菜系/湘菜
玉带鱿鱼带	饮食/2烹饪/2中国烹饪/2八大菜系/湘菜
油酥红虾	饮食/2烹饪/2中国烹饪/2八大菜系/湘菜
油炝蚕豆	饮食/2烹饪/2中国烹饪/2八大菜系/湘菜
腰果熘虾仁	饮食/2烹饪/2中国烹饪/2八大菜系/湘菜
鱼子烧豆腐	饮食/2烹饪/2中国烹饪/2八大菜系/湘菜
原蒸肚片	饮食/2烹饪/2中国烹饪/2八大菜系/湘菜
鸭酱茄子皮	饮食/2烹饪/2中国烹饪/2八大菜系/湘菜
中国湘菜网	饮食/2烹饪/2中国烹饪/2八大菜系/湘菜
子龙脱袍	饮食/2烹饪/2中国烹饪/2八大菜系/湘菜
左宗棠鸡	饮食/2烹饪/2中国烹饪/2八大菜系/湘菜
杂瓣海参	饮食/2烹饪/2中国烹饪/2八大菜系/湘菜
炸八块	饮食/2烹饪/2中国烹饪/2八大菜系/湘菜
珠梅土鸡	饮食/2烹饪/2中国烹饪/2八大菜系/湘菜
祖庵玉结鱼翅	饮食/2烹饪/2中国烹饪/2八大菜系/湘菜
竹笙鸳鸯卷	饮食/2烹饪/2中国烹饪/2八大菜系/湘菜
紫米珍珠丸	饮食/2烹饪/2中国烹饪/2八大菜系/湘菜
紫苏炒田螺	饮食/2烹饪/2中国烹饪/2八大菜系/湘菜
紫菜鱼丸汤	饮食/2烹饪/2中国烹饪/2八大菜系/湘菜
纸包排骨	饮食/2烹饪/2中国烹饪/2八大菜系/湘菜
组庵鱼翅	饮食/2烹饪/2中国烹饪/2八大菜系/湘菜
芝士海鲜盏	饮食/2烹饪/2中国烹饪/2八大菜系/湘菜
蒸白菜卷	饮食/2烹饪/2中国烹饪/2八大菜系/湘菜
走油豆豉扣肉	饮食/2烹饪/2中国烹饪/2八大菜系/湘菜
走油豆鼓扣肉	饮食/2烹饪/2中国烹饪/2八大菜系/湘菜
醉仙掌	饮食/2烹饪/2中国烹饪/2八大菜系/湘菜
鹧鸪海马紫砂炖汤	饮食/2烹饪/2中国烹饪/2八大菜系/湘菜
紫苏煎黄瓜	饮食/2烹饪/2中国烹饪/2八大菜系/湘菜
孜然精排	饮食/2烹饪/2中国烹饪/2八大菜系/湘菜
组庵玉结鱼翅	饮食/2烹饪/2中国烹饪/2八大菜系/湘菜
紫龙脱袍煲	饮食/2烹饪/2中国烹饪/2八大菜系/湘菜
走油猪蹄	饮食/2烹饪/2中国烹饪/2八大菜系/湘菜
炸灌小肠	饮食/2烹饪/2中国烹饪/2八大菜系/湘菜
紫菜汆鱼	饮食/2烹饪/2中国烹饪/2八大菜系/湘菜
炸滑鱼排	饮食/2烹饪/2中国烹饪/2八大菜系/湘菜
竹筒豆豉蒸排骨	饮食/2烹饪/2中国烹饪/2八大菜系/湘菜
蒸丝瓜	饮食/2烹饪/2中国烹饪/2八大菜系/湘菜
组庵湘菜	饮食/2烹饪/2中国烹饪/2八大菜系/湘菜
八卦汤	饮食/2烹饪/2中国烹饪/2八大菜系/浙菜
八味酿笋	饮食/2烹饪/2中国烹饪/2八大菜系/浙菜
八宝山药泥	饮食/2烹饪/2中国烹饪/2八大菜系/浙菜
八宝桂鱼	饮食/2烹饪/2中国烹饪/2八大菜系/浙菜
八宝碎扣鸭	饮食/2烹饪/2中国烹饪/2八大菜系/浙菜
八宝酿凉瓜	饮食/2烹饪/2中国烹饪/2八大菜系/浙菜
八宝香糯	饮食/2烹饪/2中国烹饪/2八大菜系/浙菜
八宝鸡	饮食/2烹饪/2中国烹饪/2八大菜系/浙菜
八宝鸭羹	饮食/2烹饪/2中国烹饪/2八大菜系/浙菜
八鲜八补汤	饮食/2烹饪/2中国烹饪/2八大菜系/浙菜
冰糖排骨	饮食/2烹饪/2中国烹饪/2八大菜系/浙菜
冰糖湘莲	饮食/2烹饪/2中国烹饪/2八大菜系/浙菜
冰糖甲鱼	饮食/2烹饪/2中国烹饪/2八大菜系/浙菜
冰糖莲子	饮食/2烹饪/2中国烹饪/2八大菜系/浙菜
冰镇番茄汁	饮食/2烹饪/2中国烹饪/2八大菜系/浙菜
冰镇胡萝卜汁	饮食/2烹饪/2中国烹饪/2八大菜系/浙菜
冰镇芦笋汁	饮食/2烹饪/2中国烹饪/2八大菜系/浙菜
半煎煮银鱼	饮食/2烹饪/2中国烹饪/2八大菜系/浙菜
宝酿龙瓜	饮食/2烹饪/2中国烹饪/2八大菜系/浙菜
悲翠裙边	饮食/2烹饪/2中国烹饪/2八大菜系/浙菜
扒三样	饮食/2烹饪/2中国烹饪/2八大菜系/浙菜
扒大肠油菜	饮食/2烹饪/2中国烹饪/2八大菜系/浙菜
扒海羊	饮食/2烹饪/2中国烹饪/2八大菜系/浙菜
扒白菇	饮食/2烹饪/2中国烹饪/2八大菜系/浙菜
扒白菰	饮食/2烹饪/2中国烹饪/2八大菜系/浙菜
拌茄泥	饮食/2烹饪/2中国烹饪/2八大菜系/浙菜
拌莴笋	饮食/2烹饪/2中国烹饪/2八大菜系/浙菜
拌鸡块	饮食/2烹饪/2中国烹饪/2八大菜系/浙菜
拌鸭掌	饮食/2烹饪/2中国烹饪/2八大菜系/浙菜
拔丝红薯	饮食/2烹饪/2中国烹饪/2八大菜系/浙菜
拔丝蜜桔	饮食/2烹饪/2中国烹饪/2八大菜系/浙菜
拔丝金枣	饮食/2烹饪/2中国烹饪/2八大菜系/浙菜
本土炸酱鸡	饮食/2烹饪/2中国烹饪/2八大菜系/浙菜
棒棒鸡	饮食/2烹饪/2中国烹饪/2八大菜系/浙菜
煲烧凤翅	饮食/2烹饪/2中国烹饪/2八大菜系/浙菜
煸馅水饺	饮食/2烹饪/2中国烹饪/2八大菜系/浙菜
爆双脆	饮食/2烹饪/2中国烹饪/2八大菜系/浙菜
爆四丁	饮食/2烹饪/2中国烹饪/2八大菜系/浙菜
爆墨鱼卷	饮食/2烹饪/2中国烹饪/2八大菜系/浙菜
爆墨鱼花	饮食/2烹饪/2中国烹饪/2八大菜系/浙菜
爆素鳝丝	饮食/2烹饪/2中国烹饪/2八大菜系/浙菜
玻璃明虾	饮食/2烹饪/2中国烹饪/2八大菜系/浙菜
白云猪手	饮食/2烹饪/2中国烹饪/2八大菜系/浙菜
白兔冷盘	饮食/2烹饪/2中国烹饪/2八大菜系/浙菜
白及冰糖燕窝	饮食/2烹饪/2中国烹饪/2八大菜系/浙菜
白字焖肉	饮食/2烹饪/2中国烹饪/2八大菜系/浙菜
白汁全鱼	饮食/2烹饪/2中国烹饪/2八大菜系/浙菜
白汁甘笋	饮食/2烹饪/2中国烹饪/2八大菜系/浙菜
白油肝片	饮食/2烹饪/2中国烹饪/2八大菜系/浙菜
白煮肉	饮食/2烹饪/2中国烹饪/2八大菜系/浙菜
白羊肾羹	饮食/2烹饪/2中国烹饪/2八大菜系/浙菜
白肚	饮食/2烹饪/2中国烹饪/2八大菜系/浙菜
白菜扣虾	饮食/2烹饪/2中国烹饪/2八大菜系/浙菜
白菜木须	饮食/2烹饪/2中国烹饪/2八大菜系/浙菜
白鲞扣鸡	饮食/2烹饪/2中国烹饪/2八大菜系/浙菜
百花鸡	饮食/2烹饪/2中国烹饪/2八大菜系/浙菜
碧波龙舟	饮食/2烹饪/2中国烹饪/2八大菜系/浙菜
碧玉豌豆仁	饮食/2烹饪/2中国烹饪/2八大菜系/浙菜
菠菜丸子汤	饮食/2烹饪/2中国烹饪/2八大菜系/浙菜
菠菜粥	饮食/2烹饪/2中国烹饪/2八大菜系/浙菜
菠菜蛋蓉	饮食/2烹饪/2中国烹饪/2八大菜系/浙菜
菠菜金钩豆腐汤	饮食/2烹饪/2中国烹饪/2八大菜系/浙菜
菠萝三文鱼	饮食/2烹饪/2中国烹饪/2八大菜系/浙菜
菠萝虾球	饮食/2烹饪/2中国烹饪/2八大菜系/浙菜
菠萝鸡丁	饮食/2烹饪/2中国烹饪/2八大菜系/浙菜
菠萝龙眼鱼	饮食/2烹饪/2中国烹饪/2八大菜系/浙菜
薄棒肉卷	饮食/2烹饪/2中国烹饪/2八大菜系/浙菜
薄荷蔬菜沙拉	饮食/2烹饪/2中国烹饪/2八大菜系/浙菜
贝母甲鱼	饮食/2烹饪/2中国烹饪/2八大菜系/浙菜
霸王鸡翅	饮食/2烹饪/2中国烹饪/2八大菜系/浙菜
鲍参乌骨鸡	饮食/2烹饪/2中国烹饪/2八大菜系/浙菜
鲍鱼肚片汤	饮食/2烹饪/2中国烹饪/2八大菜系/浙菜
串煎馄饨	饮食/2烹饪/2中国烹饪/2八大菜系/浙菜
出汁豆腐	饮食/2烹饪/2中国烹饪/2八大菜系/浙菜
叉烧鸭	饮食/2烹饪/2中国烹饪/2八大菜系/浙菜
川味棒棒鸡	饮食/2烹饪/2中国烹饪/2八大菜系/浙菜
春笋炒步鱼	饮食/2烹饪/2中国烹饪/2八大菜系/浙菜
春笋豌豆	饮食/2烹饪/2中国烹饪/2八大菜系/浙菜
朝阳鸡蛋豆腐	饮食/2烹饪/2中国烹饪/2八大菜系/浙菜
椿芽烘蛋	饮食/2烹饪/2中国烹饪/2八大菜系/浙菜
潮洲炒稞条	饮食/2烹饪/2中国烹饪/2八大菜系/浙菜
炊水晶虾	饮食/2烹饪/2中国烹饪/2八大菜系/浙菜
炒三丁	饮食/2烹饪/2中国烹饪/2八大菜系/浙菜
炒三泥	饮食/2烹饪/2中国烹饪/2八大菜系/浙菜
炒三脆	饮食/2烹饪/2中国烹饪/2八大菜系/浙菜
炒二冬	饮食/2烹饪/2中国烹饪/2八大菜系/浙菜
炒全肫	饮食/2烹饪/2中国烹饪/2八大菜系/浙菜
炒四宝	饮食/2烹饪/2中国烹饪/2八大菜系/浙菜
炒山药泥	饮食/2烹饪/2中国烹饪/2八大菜系/浙菜
炒木樨肉	饮食/2烹饪/2中国烹饪/2八大菜系/浙菜
炒桂花翅	饮食/2烹饪/2中国烹饪/2八大菜系/浙菜
炒番茄鸡片	饮食/2烹饪/2中国烹饪/2八大菜系/浙菜
炒皮笋	饮食/2烹饪/2中国烹饪/2八大菜系/浙菜
炒米粉	饮食/2烹饪/2中国烹饪/2八大菜系/浙菜
炒素什锦	饮食/2烹饪/2中国烹饪/2八大菜系/浙菜
炒素腰花	饮食/2烹饪/2中国烹饪/2八大菜系/浙菜
炒胡萝卜酱	饮食/2烹饪/2中国烹饪/2八大菜系/浙菜
炒茄丝	饮食/2烹饪/2中国烹饪/2八大菜系/浙菜
炒萝卜	饮食/2烹饪/2中国烹饪/2八大菜系/浙菜
炒虾仁腰果仁	饮食/2烹饪/2中国烹饪/2八大菜系/浙菜
炒西兰花	饮食/2烹饪/2中国烹饪/2八大菜系/浙菜
炒西红柿	饮食/2烹饪/2中国烹饪/2八大菜系/浙菜
炒豆腐松	饮食/2烹饪/2中国烹饪/2八大菜系/浙菜
炒豆腐脑	饮食/2烹饪/2中国烹饪/2八大菜系/浙菜
炒豌豆	饮食/2烹饪/2中国烹饪/2八大菜系/浙菜
炒里嵴丝	饮食/2烹饪/2中国烹饪/2八大菜系/浙菜
炒里脊丝	饮食/2烹饪/2中国烹饪/2八大菜系/浙菜
炒面包虾仁	饮食/2烹饪/2中国烹饪/2八大菜系/浙菜
炒鲜莴笋	饮食/2烹饪/2中国烹饪/2八大菜系/浙菜
焯炒腰花	饮食/2烹饪/2中国烹饪/2八大菜系/浙菜
翠椒炝蜗牛	饮食/2烹饪/2中国烹饪/2八大菜系/浙菜
翠椒爆蜗牛	饮食/2烹饪/2中国烹饪/2八大菜系/浙菜
翠玉黄瓜	饮食/2烹饪/2中国烹饪/2八大菜系/浙菜
脆炸响铃	饮食/2烹饪/2中国烹饪/2八大菜系/浙菜
脆瓜里嵴丝	饮食/2烹饪/2中国烹饪/2八大菜系/浙菜
脆瓜里脊丝	饮食/2烹饪/2中国烹饪/2八大菜系/浙菜
茶香牛肉	饮食/2烹饪/2中国烹饪/2八大菜系/浙菜
茶香骨	饮食/2烹饪/2中国烹饪/2八大菜系/浙菜
菜心炒猪肝	饮食/2烹饪/2中国烹饪/2八大菜系/浙菜
菜远卤牛肉	饮食/2烹饪/2中国烹饪/2八大菜系/浙菜
葱扒鸭子	饮食/2烹饪/2中国烹饪/2八大菜系/浙菜
葱椒肉	饮食/2烹饪/2中国烹饪/2八大菜系/浙菜
葱油核桃鱼卷	饮食/2烹饪/2中国烹饪/2八大菜系/浙菜
葱油苦瓜	饮食/2烹饪/2中国烹饪/2八大菜系/浙菜
葱油黄鱼	饮食/2烹饪/2中国烹饪/2八大菜系/浙菜
葱炖猪蹄	饮食/2烹饪/2中国烹饪/2八大菜系/浙菜
葱烧乌叁	饮食/2烹饪/2中国烹饪/2八大菜系/浙菜
葱爆兔肉	饮食/2烹饪/2中国烹饪/2八大菜系/浙菜
葱爆鸡块	饮食/2烹饪/2中国烹饪/2八大菜系/浙菜
葱爆鸡快	饮食/2烹饪/2中国烹饪/2八大菜系/浙菜
葱辣鱼条	饮食/2烹饪/2中国烹饪/2八大菜系/浙菜
藏心鱼圆	饮食/2烹饪/2中国烹饪/2八大菜系/浙菜
虫草全鸭	饮食/2烹饪/2中国烹饪/2八大菜系/浙菜
虫草杜仲炖海虾	饮食/2烹饪/2中国烹饪/2八大菜系/浙菜
豉姜泥鳅	饮食/2烹饪/2中国烹饪/2八大菜系/浙菜
豉椒蒸腊肉	饮食/2烹饪/2中国烹饪/2八大菜系/浙菜
豉汁苦瓜	饮食/2烹饪/2中国烹饪/2八大菜系/浙菜
醋椒活鱼	饮食/2烹饪/2中国烹饪/2八大菜系/浙菜
醋椒鱼	饮食/2烹饪/2中国烹饪/2八大菜系/浙菜
醋溜藕片	饮食/2烹饪/2中国烹饪/2八大菜系/浙菜
醋熘块鱼	饮食/2烹饪/2中国烹饪/2八大菜系/浙菜
醋熘白菜	饮食/2烹饪/2中国烹饪/2八大菜系/浙菜
醋熘藕片	饮食/2烹饪/2中国烹饪/2八大菜系/浙菜
醋熘鸡	饮食/2烹饪/2中国烹饪/2八大菜系/浙菜
长江豆干汤	饮食/2烹饪/2中国烹饪/2八大菜系/浙菜
东坡肉	饮食/2烹饪/2中国烹饪/2八大菜系/浙菜
东江盐浸鸡	饮食/2烹饪/2中国烹饪/2八大菜系/浙菜
东江盐焗鸡	饮食/2烹饪/2中国烹饪/2八大菜系/浙菜
东江豆腐煲	饮食/2烹饪/2中国烹饪/2八大菜系/浙菜
冬冬菇托儿	饮食/2烹饪/2中国烹饪/2八大菜系/浙菜
冬冬菰托儿	饮食/2烹饪/2中国烹饪/2八大菜系/浙菜
冬瓜炖排骨	饮食/2烹饪/2中国烹饪/2八大菜系/浙菜
冬瓜盅	饮食/2烹饪/2中国烹饪/2八大菜系/浙菜
冬瓜连锅汤	饮食/2烹饪/2中国烹饪/2八大菜系/浙菜
冬笋虾卷	饮食/2烹饪/2中国烹饪/2八大菜系/浙菜
冬笋雪菜黄鱼汤	饮食/2烹饪/2中国烹饪/2八大菜系/浙菜
冬茸白兰	饮食/2烹饪/2中国烹饪/2八大菜系/浙菜
冬菜扣肉	饮食/2烹饪/2中国烹饪/2八大菜系/浙菜
冬菜肉末	饮食/2烹饪/2中国烹饪/2八大菜系/浙菜
冬菰豆腐	饮食/2烹饪/2中国烹饪/2八大菜系/浙菜
冬虫夏草烩番茄	饮食/2烹饪/2中国烹饪/2八大菜系/浙菜
单腐	饮食/2烹饪/2中国烹饪/2八大菜系/浙菜
地栗糕	饮食/2烹饪/2中国烹饪/2八大菜系/浙菜
地黄花粥	饮食/2烹饪/2中国烹饪/2八大菜系/浙菜
多味黄瓜	饮食/2烹饪/2中国烹饪/2八大菜系/浙菜
大团圆	饮食/2烹饪/2中国烹饪/2八大菜系/浙菜
大枣冬菇汤	饮食/2烹饪/2中国烹饪/2八大菜系/浙菜
大枣冬菰汤	饮食/2烹饪/2中国烹饪/2八大菜系/浙菜
大枣百合汤	饮食/2烹饪/2中国烹饪/2八大菜系/浙菜
大白菜水饺	饮食/2烹饪/2中国烹饪/2八大菜系/浙菜
大黄瓜镶肉	饮食/2烹饪/2中国烹饪/2八大菜系/浙菜
当归羊肉羹	饮食/2烹饪/2中国烹饪/2八大菜系/浙菜
灯影苕片	饮食/2烹饪/2中国烹饪/2八大菜系/浙菜
蛋松	饮食/2烹饪/2中国烹饪/2八大菜系/浙菜
蛋梅鸭	饮食/2烹饪/2中国烹饪/2八大菜系/浙菜
豆瓣海参	饮食/2烹饪/2中国烹饪/2八大菜系/浙菜
豆瓣鲜鱼	饮食/2烹饪/2中国烹饪/2八大菜系/浙菜
豆瓣鲜鱿	饮食/2烹饪/2中国烹饪/2八大菜系/浙菜
豆腐排骨豆芽汤	饮食/2烹饪/2中国烹饪/2八大菜系/浙菜
豆腐海鲜汤	饮食/2烹饪/2中国烹饪/2八大菜系/浙菜
豆芽咸菜	饮食/2烹饪/2中国烹饪/2八大菜系/浙菜
豆豉小辣椒	饮食/2烹饪/2中国烹饪/2八大菜系/浙菜
豆豉烧中段	饮食/2烹饪/2中国烹饪/2八大菜系/浙菜
豆豉苦瓜	饮食/2烹饪/2中国烹饪/2八大菜系/浙菜
丰收龙舟	饮食/2烹饪/2中国烹饪/2八大菜系/浙菜
佛手三丝	饮食/2烹饪/2中国烹饪/2八大菜系/浙菜
佛手凤柳片	饮食/2烹饪/2中国烹饪/2八大菜系/浙菜
佛手烩珍鲍片	饮食/2烹饪/2中国烹饪/2八大菜系/浙菜
佛手珠子	饮食/2烹饪/2中国烹饪/2八大菜系/浙菜
凤梨咖喱鸡	饮食/2烹饪/2中国烹饪/2八大菜系/浙菜
凤梨蟹柳	饮食/2烹饪/2中国烹饪/2八大菜系/浙菜
复元汤	饮食/2烹饪/2中国烹饪/2八大菜系/浙菜
奉化摇蚶	饮食/2烹饪/2中国烹饪/2八大菜系/浙菜
奉化芋头	饮食/2烹饪/2中国烹饪/2八大菜系/浙菜
法式牛油炸鱼	饮食/2烹饪/2中国烹饪/2八大菜系/浙菜
番茄泡蛋汤	饮食/2烹饪/2中国烹饪/2八大菜系/浙菜
番茄焖明虾	饮食/2烹饪/2中国烹饪/2八大菜系/浙菜
番茄牛肉	饮食/2烹饪/2中国烹饪/2八大菜系/浙菜
番茄腰柳	饮食/2烹饪/2中国烹饪/2八大菜系/浙菜
番茄豆腐	饮食/2烹饪/2中国烹饪/2八大菜系/浙菜
番茄鱼片	饮食/2烹饪/2中国烹饪/2八大菜系/浙菜
番茄鸡蛋	饮食/2烹饪/2中国烹饪/2八大菜系/浙菜
粉皮辣鱼	饮食/2烹饪/2中国烹饪/2八大菜系/浙菜
粉蒸牛肉	饮食/2烹饪/2中国烹饪/2八大菜系/浙菜
翡翠干贝冬茸羹	饮食/2烹饪/2中国烹饪/2八大菜系/浙菜
翡翠瑶柱羹	饮食/2烹饪/2中国烹饪/2八大菜系/浙菜
翡翠裙边	饮食/2烹饪/2中国烹饪/2八大菜系/浙菜
翡翠鱼珠	饮食/2烹饪/2中国烹饪/2八大菜系/浙菜
翡翠鱼粥	饮食/2烹饪/2中国烹饪/2八大菜系/浙菜
腐乳扣肉	饮食/2烹饪/2中国烹饪/2八大菜系/浙菜
腐皮包黄鱼	饮食/2烹饪/2中国烹饪/2八大菜系/浙菜
芙蓉四宝	饮食/2烹饪/2中国烹饪/2八大菜系/浙菜
芙蓉海四宝	饮食/2烹饪/2中国烹饪/2八大菜系/浙菜
芙蓉菜心	饮食/2烹饪/2中国烹饪/2八大菜系/浙菜
芙蓉蛋	饮食/2烹饪/2中国烹饪/2八大菜系/浙菜
芙蓉鱼片	饮食/2烹饪/2中国烹饪/2八大菜系/浙菜
功德豆腐	饮食/2烹饪/2中国烹饪/2八大菜系/浙菜
干火靠大虾	饮食/2烹饪/2中国烹饪/2八大菜系/浙菜
干炒牛肉丝	饮食/2烹饪/2中国烹饪/2八大菜系/浙菜
干炸黄雀	饮食/2烹饪/2中国烹饪/2八大菜系/浙菜
干烧冬笋	饮食/2烹饪/2中国烹饪/2八大菜系/浙菜
干烧荷包鱼	饮食/2烹饪/2中国烹饪/2八大菜系/浙菜
干烧萝卜	饮食/2烹饪/2中国烹饪/2八大菜系/浙菜
干烧鱼	饮食/2烹饪/2中国烹饪/2八大菜系/浙菜
干煎大虾	饮食/2烹饪/2中国烹饪/2八大菜系/浙菜
干煎黄鱼	饮食/2烹饪/2中国烹饪/2八大菜系/浙菜
干煸苦瓜丝	饮食/2烹饪/2中国烹饪/2八大菜系/浙菜
干煸茭白	饮食/2烹饪/2中国烹饪/2八大菜系/浙菜
干煸豇豆	饮食/2烹饪/2中国烹饪/2八大菜系/浙菜
干菜焖肉	饮食/2烹饪/2中国烹饪/2八大菜系/浙菜
干菜肥鸭	饮食/2烹饪/2中国烹饪/2八大菜系/浙菜
干贝萝卜汤	饮食/2烹饪/2中国烹饪/2八大菜系/浙菜
广式蒸鱼	饮食/2烹饪/2中国烹饪/2八大菜系/浙菜
归参山药猪腰	饮食/2烹饪/2中国烹饪/2八大菜系/浙菜
怪味白肉	饮食/2烹饪/2中国烹饪/2八大菜系/浙菜
怪味鸡	饮食/2烹饪/2中国烹饪/2八大菜系/浙菜
挂炉烤鸭	饮食/2烹饪/2中国烹饪/2八大菜系/浙菜
果汁煎鸡肉	饮食/2烹饪/2中国烹饪/2八大菜系/浙菜
果汁鱼块	饮食/2烹饪/2中国烹饪/2八大菜系/浙菜
果汁鲜鱼块	饮食/2烹饪/2中国烹饪/2八大菜系/浙菜
果汁鸡条	饮食/2烹饪/2中国烹饪/2八大菜系/浙菜
果酱三明治	饮食/2烹饪/2中国烹饪/2八大菜系/浙菜
枸杞肉丝	饮食/2烹饪/2中国烹饪/2八大菜系/浙菜
枸杞莲子鸡汤	饮食/2烹饪/2中国烹饪/2八大菜系/浙菜
枸杞豉汁粥	饮食/2烹饪/2中国烹饪/2八大菜系/浙菜
桂花栗子鱼	饮食/2烹饪/2中国烹饪/2八大菜系/浙菜
桂花肉	饮食/2烹饪/2中国烹饪/2八大菜系/浙菜
桂花酒酿元宵	饮食/2烹饪/2中国烹饪/2八大菜系/浙菜
桂花鱼条	饮食/2烹饪/2中国烹饪/2八大菜系/浙菜
桂鱼虾干泡丝瓜	饮食/2烹饪/2中国烹饪/2八大菜系/浙菜
甘蓝什锦串	饮食/2烹饪/2中国烹饪/2八大菜系/浙菜
罐焖核桃鸡块	饮食/2烹饪/2中国烹饪/2八大菜系/浙菜
菰酒汁烧三文鱼	饮食/2烹饪/2中国烹饪/2八大菜系/浙菜
蛤蜊氽鲫鱼	饮食/2烹饪/2中国烹饪/2八大菜系/浙菜
蛤蜊鲫鱼	饮食/2烹饪/2中国烹饪/2八大菜系/浙菜
贵妃鸡翅	饮食/2烹饪/2中国烹饪/2八大菜系/浙菜
锅塌白菜	饮食/2烹饪/2中国烹饪/2八大菜系/浙菜
锅塌茄盒	饮食/2烹饪/2中国烹饪/2八大菜系/浙菜
锅巴虾仁	饮食/2烹饪/2中国烹饪/2八大菜系/浙菜
锅烧豆腐	饮食/2烹饪/2中国烹饪/2八大菜系/浙菜
锅烧鳗	饮食/2烹饪/2中国烹饪/2八大菜系/浙菜
锅煸豆腐	饮食/2烹饪/2中国烹饪/2八大菜系/浙菜
锅煽豆腐	饮食/2烹饪/2中国烹饪/2八大菜系/浙菜
锅贴鱼片	饮食/2烹饪/2中国烹饪/2八大菜系/浙菜
锅蹋韭菜	饮食/2烹饪/2中国烹饪/2八大菜系/浙菜
锅酥牛肉	饮食/2烹饪/2中国烹饪/2八大菜系/浙菜
高丽香蕉	饮食/2烹饪/2中国烹饪/2八大菜系/浙菜
高丽鱼条	饮食/2烹饪/2中国烹饪/2八大菜系/浙菜
回锅鱼	饮食/2烹饪/2中国烹饪/2八大菜系/浙菜
好味鸡	饮食/2烹饪/2中国烹饪/2八大菜系/浙菜
杭三鲜	饮食/2烹饪/2中国烹饪/2八大菜系/浙菜
杭州皇饭儿夹豆腐	饮食/2烹饪/2中国烹饪/2八大菜系/浙菜
杭州素火腿	饮食/2烹饪/2中国烹饪/2八大菜系/浙菜
杭州菜	饮食/2烹饪/2中国烹饪/2八大菜系/浙菜
杭州菜卤豆腐	饮食/2烹饪/2中国烹饪/2八大菜系/浙菜
杭州酱鸭	饮食/2烹饪/2中国烹饪/2八大菜系/浙菜
杭帮菜	饮食/2烹饪/2中国烹饪/2八大菜系/浙菜
核桃仁粥	饮食/2烹饪/2中国烹饪/2八大菜系/浙菜
核桃鸡丁	饮食/2烹饪/2中国烹饪/2八大菜系/浙菜
核桃鸡条	饮食/2烹饪/2中国烹饪/2八大菜系/浙菜
海参什锦肉片	饮食/2烹饪/2中国烹饪/2八大菜系/浙菜
海味豆腐汤	饮食/2烹饪/2中国烹饪/2八大菜系/浙菜
海米冬瓜	饮食/2烹饪/2中国烹饪/2八大菜系/浙菜
海米冬瓜汤	饮食/2烹饪/2中国烹饪/2八大菜系/浙菜
海米拌油菜	饮食/2烹饪/2中国烹饪/2八大菜系/浙菜
海米拌莴笋	饮食/2烹饪/2中国烹饪/2八大菜系/浙菜
海米拌菜花	饮食/2烹饪/2中国烹饪/2八大菜系/浙菜
海米拌黄瓜	饮食/2烹饪/2中国烹饪/2八大菜系/浙菜
海米烧茄	饮食/2烹饪/2中国烹饪/2八大菜系/浙菜
海米烧茄子	饮食/2烹饪/2中国烹饪/2八大菜系/浙菜
海米烧菜花	饮食/2烹饪/2中国烹饪/2八大菜系/浙菜
海米烧萝卜	饮食/2烹饪/2中国烹饪/2八大菜系/浙菜
海米白菜汤	饮食/2烹饪/2中国烹饪/2八大菜系/浙菜
海米萝卜汤	饮食/2烹饪/2中国烹饪/2八大菜系/浙菜
海米豇豆	饮食/2烹饪/2中国烹饪/2八大菜系/浙菜
海陆煲	饮食/2烹饪/2中国烹饪/2八大菜系/浙菜
海鲜铁锅烧	饮食/2烹饪/2中国烹饪/2八大菜系/浙菜
滑肉白菜	饮食/2烹饪/2中国烹饪/2八大菜系/浙菜
滑肉莴笋	饮食/2烹饪/2中国烹饪/2八大菜系/浙菜
火腿土司	饮食/2烹饪/2中国烹饪/2八大菜系/浙菜
火腿白菜	饮食/2烹饪/2中国烹饪/2八大菜系/浙菜
火腿萝卜丝汤	饮食/2烹饪/2中国烹饪/2八大菜系/浙菜
火腿酥腰	饮食/2烹饪/2中国烹饪/2八大菜系/浙菜
火腿鱼	饮食/2烹饪/2中国烹饪/2八大菜系/浙菜
火踵神仙鸭	饮食/2烹饪/2中国烹饪/2八大菜系/浙菜
火踵蹄膀	饮食/2烹饪/2中国烹饪/2八大菜系/浙菜
火踵鱼翅	饮食/2烹饪/2中国烹饪/2八大菜系/浙菜
烩肚丝烂蒜	饮食/2烹饪/2中国烹饪/2八大菜系/浙菜
烩金银丝	饮食/2烹饪/2中国烹饪/2八大菜系/浙菜
烩鱼白	饮食/2烹饪/2中国烹饪/2八大菜系/浙菜
煳辣银芽肉丝	饮食/2烹饪/2中国烹饪/2八大菜系/浙菜
猴头四宝	饮食/2烹饪/2中国烹饪/2八大菜系/浙菜
糊辣银芽肉丝	饮食/2烹饪/2中国烹饪/2八大菜系/浙菜
红枣炖肘	饮食/2烹饪/2中国烹饪/2八大菜系/浙菜
红枣烧肉	饮食/2烹饪/2中国烹饪/2八大菜系/浙菜
红油茄泥	饮食/2烹饪/2中国烹饪/2八大菜系/浙菜
红油鸡块	饮食/2烹饪/2中国烹饪/2八大菜系/浙菜
红烧下巴	饮食/2烹饪/2中国烹饪/2八大菜系/浙菜
红烧冬瓜	饮食/2烹饪/2中国烹饪/2八大菜系/浙菜
红烧卷鸡	饮食/2烹饪/2中国烹饪/2八大菜系/浙菜
红烧海皇翅	饮食/2烹饪/2中国烹饪/2八大菜系/浙菜
红烧烤麸	饮食/2烹饪/2中国烹饪/2八大菜系/浙菜
红烧狗肉	饮食/2烹饪/2中国烹饪/2八大菜系/浙菜
红烧猴头蘑	饮食/2烹饪/2中国烹饪/2八大菜系/浙菜
红烧素什锦	饮食/2烹饪/2中国烹饪/2八大菜系/浙菜
红烧肉	饮食/2烹饪/2中国烹饪/2八大菜系/浙菜
红烧萝卜	饮食/2烹饪/2中国烹饪/2八大菜系/浙菜
红烧蹄筋	饮食/2烹饪/2中国烹饪/2八大菜系/浙菜
红焖麻雀	饮食/2烹饪/2中国烹饪/2八大菜系/浙菜
红苕泥	饮食/2烹饪/2中国烹饪/2八大菜系/浙菜
红菱子鸡	饮食/2烹饪/2中国烹饪/2八大菜系/浙菜
红颜菜汤	饮食/2烹饪/2中国烹饪/2八大菜系/浙菜
胡萝卜粥	饮食/2烹饪/2中国烹饪/2八大菜系/浙菜
花卷鱿鱼	饮食/2烹饪/2中国烹饪/2八大菜系/浙菜
花椒嫩醉鸡	饮食/2烹饪/2中国烹饪/2八大菜系/浙菜
花生仁拌芹菜	饮食/2烹饪/2中国烹饪/2八大菜系/浙菜
荷包豆腐	饮食/2烹饪/2中国烹饪/2八大菜系/浙菜
荷包鲜肉	饮食/2烹饪/2中国烹饪/2八大菜系/浙菜
荷叶新凤鸡	饮食/2烹饪/2中国烹饪/2八大菜系/浙菜
荷叶蒸鱼	饮食/2烹饪/2中国烹饪/2八大菜系/浙菜
荷叶饭	饮食/2烹饪/2中国烹饪/2八大菜系/浙菜
荷花干贝汤	饮食/2烹饪/2中国烹饪/2八大菜系/浙菜
荷香笼仔鸭	饮食/2烹饪/2中国烹饪/2八大菜系/浙菜
虎皮蛋	饮食/2烹饪/2中国烹饪/2八大菜系/浙菜
虎跑素火腿	饮食/2烹饪/2中国烹饪/2八大菜系/浙菜
蚝油扒冬瓜	饮食/2烹饪/2中国烹饪/2八大菜系/浙菜
蚝油炒草菰	饮食/2烹饪/2中国烹饪/2八大菜系/浙菜
蚝油焖平菰	饮食/2烹饪/2中国烹饪/2八大菜系/浙菜
蚝油芦笋沙律	饮食/2烹饪/2中国烹饪/2八大菜系/浙菜
蚝油芦笋砂律	饮食/2烹饪/2中国烹饪/2八大菜系/浙菜
蚝油茭白	饮食/2烹饪/2中国烹饪/2八大菜系/浙菜
蚝油鲜菇	饮食/2烹饪/2中国烹饪/2八大菜系/浙菜
蚝油鲜菰	饮食/2烹饪/2中国烹饪/2八大菜系/浙菜
蝴蝶瓜	饮食/2烹饪/2中国烹饪/2八大菜系/浙菜
馄饨千层饼	饮食/2烹饪/2中国烹饪/2八大菜系/浙菜
馄饨香蕉卷	饮食/2烹饪/2中国烹饪/2八大菜系/浙菜
京都排骨	饮食/2烹饪/2中国烹饪/2八大菜系/浙菜
京酱肉丝	饮食/2烹饪/2中国烹饪/2八大菜系/浙菜
叫化童子鸡	饮食/2烹饪/2中国烹饪/2八大菜系/浙菜
吉列生蚝	饮食/2烹饪/2中国烹饪/2八大菜系/浙菜
姜拌藕	饮食/2烹饪/2中国烹饪/2八大菜系/浙菜
姜汁刀豆	饮食/2烹饪/2中国烹饪/2八大菜系/浙菜
姜汁菠菜	饮食/2烹饪/2中国烹饪/2八大菜系/浙菜
姜醋白切蟹	饮食/2烹饪/2中国烹饪/2八大菜系/浙菜
家乡芝士蛋糕	饮食/2烹饪/2中国烹饪/2八大菜系/浙菜
家常茄子	饮食/2烹饪/2中国烹饪/2八大菜系/浙菜
尖椒肉丝	饮食/2烹饪/2中国烹饪/2八大菜系/浙菜
巨无霸牛肋排	饮食/2烹饪/2中国烹饪/2八大菜系/浙菜
桔络丸子	饮食/2烹饪/2中国烹饪/2八大菜系/浙菜
椒油炝芹菜	饮食/2烹饪/2中国烹饪/2八大菜系/浙菜
椒盐竹仔鱼	饮食/2烹饪/2中国烹饪/2八大菜系/浙菜
椒麻鱿花	饮食/2烹饪/2中国烹饪/2八大菜系/浙菜
椒麻鸡	饮食/2烹饪/2中国烹饪/2八大菜系/浙菜
江南小食几款	饮食/2烹饪/2中国烹饪/2八大菜系/浙菜
江瑶柱炖鸽皇	饮食/2烹饪/2中国烹饪/2八大菜系/浙菜
江米藕	饮食/2烹饪/2中国烹饪/2八大菜系/浙菜
江苏煎饼	饮食/2烹饪/2中国烹饪/2八大菜系/浙菜
焦溜肥肠	饮食/2烹饪/2中国烹饪/2八大菜系/浙菜
焦熘肥肠	饮食/2烹饪/2中国烹饪/2八大菜系/浙菜
煎茄片	饮食/2烹饪/2中国烹饪/2八大菜系/浙菜
煎豆腐鱼烙	饮食/2烹饪/2中国烹饪/2八大菜系/浙菜
煎酿斑鸠	饮食/2烹饪/2中国烹饪/2八大菜系/浙菜
芥末鸡条	饮食/2烹饪/2中国烹饪/2八大菜系/浙菜
茭白炒毛豆	饮食/2烹饪/2中国烹饪/2八大菜系/浙菜
茭白烧腊肉	饮食/2烹饪/2中国烹饪/2八大菜系/浙菜
荠菜干贝羹	饮食/2烹饪/2中国烹饪/2八大菜系/浙菜
荠菜肉馄饨	饮食/2烹饪/2中国烹饪/2八大菜系/浙菜
荠菜雉鸡片	饮食/2烹饪/2中国烹饪/2八大菜系/浙菜
菊花对蟹	饮食/2烹饪/2中国烹饪/2八大菜系/浙菜
菊花粥	饮食/2烹饪/2中国烹饪/2八大菜系/浙菜
菊花鱼	饮食/2烹饪/2中国烹饪/2八大菜系/浙菜
菊花鲈鱼块	饮食/2烹饪/2中国烹饪/2八大菜系/浙菜
豇豆烧肉	饮食/2烹饪/2中国烹饪/2八大菜系/浙菜
酒酿斑鸠	饮食/2烹饪/2中国烹饪/2八大菜系/浙菜
酒酿鸽蛋	饮食/2烹饪/2中国烹饪/2八大菜系/浙菜
酱味烤海鱼	饮食/2烹饪/2中国烹饪/2八大菜系/浙菜
酱汁活鱼	饮食/2烹饪/2中国烹饪/2八大菜系/浙菜
酱烧冬瓜条	饮食/2烹饪/2中国烹饪/2八大菜系/浙菜
酱烧整步鱼	饮食/2烹饪/2中国烹饪/2八大菜系/浙菜
酱烧茄	饮食/2烹饪/2中国烹饪/2八大菜系/浙菜
酱烧茄子	饮食/2烹饪/2中国烹饪/2八大菜系/浙菜
酱烧茄条	饮食/2烹饪/2中国烹饪/2八大菜系/浙菜
酱烧茭白	饮食/2烹饪/2中国烹饪/2八大菜系/浙菜
酱爆兔肉丁	饮食/2烹饪/2中国烹饪/2八大菜系/浙菜
酱爆肉酥饼	饮食/2烹饪/2中国烹饪/2八大菜系/浙菜
酱爆茄豆	饮食/2烹饪/2中国烹饪/2八大菜系/浙菜
酱爆螺丝	饮食/2烹饪/2中国烹饪/2八大菜系/浙菜
酱爆青蟹	饮食/2烹饪/2中国烹饪/2八大菜系/浙菜
酱瓜炒肉丝	饮食/2烹饪/2中国烹饪/2八大菜系/浙菜
酱腌紫茄	饮食/2烹饪/2中国烹饪/2八大菜系/浙菜
金牛鸭子	饮食/2烹饪/2中国烹饪/2八大菜系/浙菜
金莲戏鱼	饮食/2烹饪/2中国烹饪/2八大菜系/浙菜
金针炒肉丝	饮食/2烹饪/2中国烹饪/2八大菜系/浙菜
金钱鸡卷	饮食/2烹饪/2中国烹饪/2八大菜系/浙菜
金银炒蛋	饮食/2烹饪/2中国烹饪/2八大菜系/浙菜
金银蛋烩时菜	饮食/2烹饪/2中国烹饪/2八大菜系/浙菜
金银蹄	饮食/2烹饪/2中国烹饪/2八大菜系/浙菜
锦绣鱼丝	饮食/2烹饪/2中国烹饪/2八大菜系/浙菜
锦锈龙虾	饮食/2烹饪/2中国烹饪/2八大菜系/浙菜
韭菜墨鱼丝	饮食/2烹饪/2中国烹饪/2八大菜系/浙菜
韭菜干丝	饮食/2烹饪/2中国烹饪/2八大菜系/浙菜
韭菜炒绿豆芽	饮食/2烹饪/2中国烹饪/2八大菜系/浙菜
韭菜肉片汤	饮食/2烹饪/2中国烹饪/2八大菜系/浙菜
韭黄墨鱼卷	饮食/2烹饪/2中国烹饪/2八大菜系/浙菜
韭黄带丝汤	饮食/2烹饪/2中国烹饪/2八大菜系/浙菜
韭黄拌干丝	饮食/2烹饪/2中国烹饪/2八大菜系/浙菜
韭黄肉丝	饮食/2烹饪/2中国烹饪/2八大菜系/浙菜
卡夫果丝春卷	饮食/2烹饪/2中国烹饪/2八大菜系/浙菜
咖喱炒干丝	饮食/2烹饪/2中国烹饪/2八大菜系/浙菜
咖喱牛百叶汤	饮食/2烹饪/2中国烹饪/2八大菜系/浙菜
咖喱螃蟹	饮食/2烹饪/2中国烹饪/2八大菜系/浙菜
咖喱鸡块	饮食/2烹饪/2中国烹饪/2八大菜系/浙菜
孔雀开屏鸭	饮食/2烹饪/2中国烹饪/2八大菜系/浙菜
开洋萝卜丝汤	饮食/2烹饪/2中国烹饪/2八大菜系/浙菜
扣四丝	饮食/2烹饪/2中国烹饪/2八大菜系/浙菜
扣鸡	饮食/2烹饪/2中国烹饪/2八大菜系/浙菜
昆布鸡腿汤	饮食/2烹饪/2中国烹饪/2八大菜系/浙菜
烤兔肉	饮食/2烹饪/2中国烹饪/2八大菜系/浙菜
烤奶酪水饺皮	饮食/2烹饪/2中国烹饪/2八大菜系/浙菜
烤扁担肉	饮食/2烹饪/2中国烹饪/2八大菜系/浙菜
烤明虾	饮食/2烹饪/2中国烹饪/2八大菜系/浙菜
烤鸡肉串	饮食/2烹饪/2中国烹饪/2八大菜系/浙菜
烤麸大包	饮食/2烹饪/2中国烹饪/2八大菜系/浙菜
苦中作乐	饮食/2烹饪/2中国烹饪/2八大菜系/浙菜
苦瓜粥	饮食/2烹饪/2中国烹饪/2八大菜系/浙菜
苦瓜镶肉	饮食/2烹饪/2中国烹饪/2八大菜系/浙菜
苦瓜鸡片	饮食/2烹饪/2中国烹饪/2八大菜系/浙菜
两吃菠菜	饮食/2烹饪/2中国烹饪/2八大菜系/浙菜
兰花春笋	饮食/2烹饪/2中国烹饪/2八大菜系/浙菜
兰花鲜带子	饮食/2烹饪/2中国烹饪/2八大菜系/浙菜
凉拌三丝	饮食/2烹饪/2中国烹饪/2八大菜系/浙菜
凉拌冬瓜	饮食/2烹饪/2中国烹饪/2八大菜系/浙菜
凉拌四宝	饮食/2烹饪/2中国烹饪/2八大菜系/浙菜
凉拌海蜇	饮食/2烹饪/2中国烹饪/2八大菜系/浙菜
凉拌苦瓜	饮食/2烹饪/2中国烹饪/2八大菜系/浙菜
凉拌茭白	饮食/2烹饪/2中国烹饪/2八大菜系/浙菜
凉拌藕片	饮食/2烹饪/2中国烹饪/2八大菜系/浙菜
凉拌豆腐	饮食/2烹饪/2中国烹饪/2八大菜系/浙菜
凉拌豇豆	饮食/2烹饪/2中国烹饪/2八大菜系/浙菜
凉拌馄饨皮	饮食/2烹饪/2中国烹饪/2八大菜系/浙菜
凉拌鱿鱼	饮食/2烹饪/2中国烹饪/2八大菜系/浙菜
凉瓜牛肉丝	饮食/2烹饪/2中国烹饪/2八大菜系/浙菜
卤汁豆干	饮食/2烹饪/2中国烹饪/2八大菜系/浙菜
卤瓜氽黄鱼	饮食/2烹饪/2中国烹饪/2八大菜系/浙菜
栗子炒子鸡	饮食/2烹饪/2中国烹饪/2八大菜系/浙菜
栗子烧鸡	饮食/2烹饪/2中国烹饪/2八大菜系/浙菜
栗子黄焖鸡	饮食/2烹饪/2中国烹饪/2八大菜系/浙菜
溜藕片	饮食/2烹饪/2中国烹饪/2八大菜系/浙菜
溜辣汁鸡	饮食/2烹饪/2中国烹饪/2八大菜系/浙菜
炉鸭丝炒冬笋丝	饮食/2烹饪/2中国烹饪/2八大菜系/浙菜
烂松菜滚豆腐	饮食/2烹饪/2中国烹饪/2八大菜系/浙菜
熘土豆丝	饮食/2烹饪/2中国烹饪/2八大菜系/浙菜
熘小黄瓜	饮食/2烹饪/2中国烹饪/2八大菜系/浙菜
熘豆芽	饮食/2烹饪/2中国烹饪/2八大菜系/浙菜
熘辣汁鸡	饮食/2烹饪/2中国烹饪/2八大菜系/浙菜
绿豆冬瓜汤	饮食/2烹饪/2中国烹饪/2八大菜系/浙菜
罗汉上素	饮食/2烹饪/2中国烹饪/2八大菜系/浙菜
老姜汤肉片汤	饮食/2烹饪/2中国烹饪/2八大菜系/浙菜
老板鱼酸菜炖豆腐汤	饮食/2烹饪/2中国烹饪/2八大菜系/浙菜
老鸭煲	饮食/2烹饪/2中国烹饪/2八大菜系/浙菜
腊肉	饮食/2烹饪/2中国烹饪/2八大菜系/浙菜
芦笋手卷	饮食/2烹饪/2中国烹饪/2八大菜系/浙菜
芦笋炒鸡柳	饮食/2烹饪/2中国烹饪/2八大菜系/浙菜
芦笋虾球	饮食/2烹饪/2中国烹饪/2八大菜系/浙菜
芦笋鸡块	饮食/2烹饪/2中国烹饪/2八大菜系/浙菜
荔枝肉球	饮食/2烹饪/2中国烹饪/2八大菜系/浙菜
莲篷豆腐	饮食/2烹饪/2中国烹饪/2八大菜系/浙菜
莲香脱骨鸡	饮食/2烹饪/2中国烹饪/2八大菜系/浙菜
萝卜杏仁煮牛肺	饮食/2烹饪/2中国烹饪/2八大菜系/浙菜
萝卜氽鲫鱼	饮食/2烹饪/2中国烹饪/2八大菜系/浙菜
萝卜连锅汤	饮食/2烹饪/2中国烹饪/2八大菜系/浙菜
萝玛精选肋排	饮食/2烹饪/2中国烹饪/2八大菜系/浙菜
蛎黄跑蛋	饮食/2烹饪/2中国烹饪/2八大菜系/浙菜
蜡椒鱼	饮食/2烹饪/2中国烹饪/2八大菜系/浙菜
蜡椒鱼辣椒蟹	饮食/2烹饪/2中国烹饪/2八大菜系/浙菜
辣味肉皮冻	饮食/2烹饪/2中国烹饪/2八大菜系/浙菜
辣子肉丁	饮食/2烹饪/2中国烹饪/2八大菜系/浙菜
辣子鱼块	饮食/2烹饪/2中国烹饪/2八大菜系/浙菜
辣汁茄丝	饮食/2烹饪/2中国烹饪/2八大菜系/浙菜
辣油里嵴丝	饮食/2烹饪/2中国烹饪/2八大菜系/浙菜
辣油里脊丝	饮食/2烹饪/2中国烹饪/2八大菜系/浙菜
辣鱼粉皮	饮食/2烹饪/2中国烹饪/2八大菜系/浙菜
墨西哥水饺片	饮食/2烹饪/2中国烹饪/2八大菜系/浙菜
密汁鲜果	饮食/2烹饪/2中国烹饪/2八大菜系/浙菜
木耳粥	饮食/2烹饪/2中国烹饪/2八大菜系/浙菜
木耳顺风	饮食/2烹饪/2中国烹饪/2八大菜系/浙菜
梅子肉	饮食/2烹饪/2中国烹饪/2八大菜系/浙菜
梅子蒸排骨	饮食/2烹饪/2中国烹饪/2八大菜系/浙菜
梅子豉椒蟹	饮食/2烹饪/2中国烹饪/2八大菜系/浙菜
梅林里嵴	饮食/2烹饪/2中国烹饪/2八大菜系/浙菜
梅林里脊	饮食/2烹饪/2中国烹饪/2八大菜系/浙菜
毛豆煎臭豆腐	饮食/2烹饪/2中国烹饪/2八大菜系/浙菜
焖茄子条	饮食/2烹饪/2中国烹饪/2八大菜系/浙菜
玛瑙野鸭片	饮食/2烹饪/2中国烹饪/2八大菜系/浙菜
玫魂果炸	饮食/2烹饪/2中国烹饪/2八大菜系/浙菜
米粉蒸肉	饮食/2烹饪/2中国烹饪/2八大菜系/浙菜
米苋黄鱼羹	饮食/2烹饪/2中国烹饪/2八大菜系/浙菜
米茄菠萝烧	饮食/2烹饪/2中国烹饪/2八大菜系/浙菜
芒果色拉	饮食/2烹饪/2中国烹饪/2八大菜系/浙菜
茉莉鱼丁	饮食/2烹饪/2中国烹饪/2八大菜系/浙菜
蘑菰炖豆腐	饮食/2烹饪/2中国烹饪/2八大菜系/浙菜
蜜桔鸡丁	饮食/2烹饪/2中国烹饪/2八大菜系/浙菜
蜜汁春鸡	饮食/2烹饪/2中国烹饪/2八大菜系/浙菜
蜜汁火方	饮食/2烹饪/2中国烹饪/2八大菜系/浙菜
蜜汁红芋	饮食/2烹饪/2中国烹饪/2八大菜系/浙菜
蜜豉串烧蚝	饮食/2烹饪/2中国烹饪/2八大菜系/浙菜
南乳笋鸡	饮食/2烹饪/2中国烹饪/2八大菜系/浙菜
南乳肉	饮食/2烹饪/2中国烹饪/2八大菜系/浙菜
南瓜汤	饮食/2烹饪/2中国烹饪/2八大菜系/浙菜
南瓜泥子汤	饮食/2烹饪/2中国烹饪/2八大菜系/浙菜
南瓜炒虾米	饮食/2烹饪/2中国烹饪/2八大菜系/浙菜
南瓜蒸肉	饮食/2烹饪/2中国烹饪/2八大菜系/浙菜
南瓜虾煲	饮食/2烹饪/2中国烹饪/2八大菜系/浙菜
南肉春笋	饮食/2烹饪/2中国烹饪/2八大菜系/浙菜
南腐肉	饮食/2烹饪/2中国烹饪/2八大菜系/浙菜
奶汤八宝布袋鸡	饮食/2烹饪/2中国烹饪/2八大菜系/浙菜
奶汤散丹	饮食/2烹饪/2中国烹饪/2八大菜系/浙菜
奶汤火腿大鱼头	饮食/2烹饪/2中国烹饪/2八大菜系/浙菜
奶汤白菜	饮食/2烹饪/2中国烹饪/2八大菜系/浙菜
奶油瓜菇汤	饮食/2烹饪/2中国烹饪/2八大菜系/浙菜
奶油瓜菰汤	饮食/2烹饪/2中国烹饪/2八大菜系/浙菜
奶油莲花白	饮食/2烹饪/2中国烹饪/2八大菜系/浙菜
奶油西兰花	饮食/2烹饪/2中国烹饪/2八大菜系/浙菜
嫩姜子鸭片	饮食/2烹饪/2中国烹饪/2八大菜系/浙菜
嫩豇豆汤	饮食/2烹饪/2中国烹饪/2八大菜系/浙菜
宁式鳝糊	饮食/2烹饪/2中国烹饪/2八大菜系/浙菜
宁氏鳝丝	饮食/2烹饪/2中国烹饪/2八大菜系/浙菜
柠汁焗鹌鹑	饮食/2烹饪/2中国烹饪/2八大菜系/浙菜
浓香鸡块	饮食/2烹饪/2中国烹饪/2八大菜系/浙菜
牛乳粥	饮食/2烹饪/2中国烹饪/2八大菜系/浙菜
牛肉串烧	饮食/2烹饪/2中国烹饪/2八大菜系/浙菜
牛肉蔬菜浓汤	饮食/2烹饪/2中国烹饪/2八大菜系/浙菜
牛肉酿鲜鱿	饮食/2烹饪/2中国烹饪/2八大菜系/浙菜
牛肝菌烧鸡	饮食/2烹饪/2中国烹饪/2八大菜系/浙菜
糯米	饮食/2烹饪/2中国烹饪/2八大菜系/浙菜
酿枇杷	饮食/2烹饪/2中国烹饪/2八大菜系/浙菜
酿青椒	饮食/2烹饪/2中国烹饪/2八大菜系/浙菜
藕片汤	饮食/2烹饪/2中国烹饪/2八大菜系/浙菜
藕香芹味	饮食/2烹饪/2中国烹饪/2八大菜系/浙菜
平湖糟蛋	饮食/2烹饪/2中国烹饪/2八大菜系/浙菜
平菇蛋汤	饮食/2烹饪/2中国烹饪/2八大菜系/浙菜
平菰肉片	饮食/2烹饪/2中国烹饪/2八大菜系/浙菜
平菰蛋汤	饮食/2烹饪/2中国烹饪/2八大菜系/浙菜
泡牛蛙	饮食/2烹饪/2中国烹饪/2八大菜系/浙菜
烹肫肝	饮食/2烹饪/2中国烹饪/2八大菜系/浙菜
烹鹌鹑	饮食/2烹饪/2中国烹饪/2八大菜系/浙菜
葡萄干焖鸡块	饮食/2烹饪/2中国烹饪/2八大菜系/浙菜
葡萄面排	饮食/2烹饪/2中国烹饪/2八大菜系/浙菜
巧克力无花果球	饮食/2烹饪/2中国烹饪/2八大菜系/浙菜
巧克力沙司	饮食/2烹饪/2中国烹饪/2八大菜系/浙菜
掐菜炒鸡丝	饮食/2烹饪/2中国烹饪/2八大菜系/浙菜
杞子炸烹大虾	饮食/2烹饪/2中国烹饪/2八大菜系/浙菜
清汤冬瓜	饮食/2烹饪/2中国烹饪/2八大菜系/浙菜
清汤柳叶燕菜	饮食/2烹饪/2中国烹饪/2八大菜系/浙菜
清汤菊花鱼	饮食/2烹饪/2中国烹饪/2八大菜系/浙菜
清汤越鸡	饮食/2烹饪/2中国烹饪/2八大菜系/浙菜
清汤鱼圆	饮食/2烹饪/2中国烹饪/2八大菜系/浙菜
清汤鱼翅	饮食/2烹饪/2中国烹饪/2八大菜系/浙菜
清汤鸡把	饮食/2烹饪/2中国烹饪/2八大菜系/浙菜
清炖全鸡	饮食/2烹饪/2中国烹饪/2八大菜系/浙菜
清炖姜归羊肉汤	饮食/2烹饪/2中国烹饪/2八大菜系/浙菜
清炖萝卜牛肉	饮食/2烹饪/2中国烹饪/2八大菜系/浙菜
清炖鱼翅	饮食/2烹饪/2中国烹饪/2八大菜系/浙菜
清炸麻雀	饮食/2烹饪/2中国烹饪/2八大菜系/浙菜
清蒸冬瓜鸡块	饮食/2烹饪/2中国烹饪/2八大菜系/浙菜
清蒸平菰	饮食/2烹饪/2中国烹饪/2八大菜系/浙菜
清蒸桂鱼	饮食/2烹饪/2中国烹饪/2八大菜系/浙菜
清蒸江团	饮食/2烹饪/2中国烹饪/2八大菜系/浙菜
清蒸石斑鱼	饮食/2烹饪/2中国烹饪/2八大菜系/浙菜
清蒸鱼	饮食/2烹饪/2中国烹饪/2八大菜系/浙菜
清蒸鲥鱼	饮食/2烹饪/2中国烹饪/2八大菜系/浙菜
清蒸鳊鱼	饮食/2烹饪/2中国烹饪/2八大菜系/浙菜
炝土豆丝	饮食/2烹饪/2中国烹饪/2八大菜系/浙菜
炝椒青笋尖	饮食/2烹饪/2中国烹饪/2八大菜系/浙菜
炝油菜	饮食/2烹饪/2中国烹饪/2八大菜系/浙菜
炝炒西兰花	饮食/2烹饪/2中国烹饪/2八大菜系/浙菜
炝菜花	饮食/2烹饪/2中国烹饪/2八大菜系/浙菜
炝豆腐	饮食/2烹饪/2中国烹饪/2八大菜系/浙菜
炝辣椒黄瓜	饮食/2烹饪/2中国烹饪/2八大菜系/浙菜
炝辣黄瓜条	饮食/2烹饪/2中国烹饪/2八大菜系/浙菜
炝青瓜条	饮食/2烹饪/2中国烹饪/2八大菜系/浙菜
芪烧活鱼	饮食/2烹饪/2中国烹饪/2八大菜系/浙菜
芹菜拌腐竹	饮食/2烹饪/2中国烹饪/2八大菜系/浙菜
芹菜牛肉丝	饮食/2烹饪/2中国烹饪/2八大菜系/浙菜
芹菜粥	饮食/2烹饪/2中国烹饪/2八大菜系/浙菜
芹菜肉丝炒苦瓜	饮食/2烹饪/2中国烹饪/2八大菜系/浙菜
芹菜肉松	饮食/2烹饪/2中国烹饪/2八大菜系/浙菜
茄子炖鸡汤	饮食/2烹饪/2中国烹饪/2八大菜系/浙菜
茄汁冬瓜排	饮食/2烹饪/2中国烹饪/2八大菜系/浙菜
茄汁斑鱼块	饮食/2烹饪/2中国烹饪/2八大菜系/浙菜
茄汁明虾	饮食/2烹饪/2中国烹饪/2八大菜系/浙菜
茄汁熘虾仁	饮食/2烹饪/2中国烹饪/2八大菜系/浙菜
茄汁牛利	饮食/2烹饪/2中国烹饪/2八大菜系/浙菜
茄汁牛肉汤	饮食/2烹饪/2中国烹饪/2八大菜系/浙菜
茄汁牛肉饼	饮食/2烹饪/2中国烹饪/2八大菜系/浙菜
茄汁菜包	饮食/2烹饪/2中国烹饪/2八大菜系/浙菜
茄汁薯枣	饮食/2烹饪/2中国烹饪/2八大菜系/浙菜
茄汤焗香鸡	饮食/2烹饪/2中国烹饪/2八大菜系/浙菜
茄片吐司	饮食/2烹饪/2中国烹饪/2八大菜系/浙菜
钱江鲈鱼	饮食/2烹饪/2中国烹饪/2八大菜系/浙菜
青椒南瓜	饮食/2烹饪/2中国烹饪/2八大菜系/浙菜
青椒炒子鸡	饮食/2烹饪/2中国烹饪/2八大菜系/浙菜
青椒皮蛋	饮食/2烹饪/2中国烹饪/2八大菜系/浙菜
青椒肉丝	饮食/2烹饪/2中国烹饪/2八大菜系/浙菜
青椒茄子	饮食/2烹饪/2中国烹饪/2八大菜系/浙菜
青椒豇豆	饮食/2烹饪/2中国烹饪/2八大菜系/浙菜
青蒜炒腊肉	饮食/2烹饪/2中国烹饪/2八大菜系/浙菜
青蔬烩肉粽	饮食/2烹饪/2中国烹饪/2八大菜系/浙菜
乳椒空心菜	饮食/2烹饪/2中国烹饪/2八大菜系/浙菜
瑞士排骨	饮食/2烹饪/2中国烹饪/2八大菜系/浙菜
瓤苦瓜	饮食/2烹饪/2中国烹饪/2八大菜系/浙菜
肉丝拌芹菜	饮食/2烹饪/2中国烹饪/2八大菜系/浙菜
肉丝炒蛋	饮食/2烹饪/2中国烹饪/2八大菜系/浙菜
肉丝粉皮	饮食/2烹饪/2中国烹饪/2八大菜系/浙菜
肉末	饮食/2烹饪/2中国烹饪/2八大菜系/浙菜
肉末四季豆	饮食/2烹饪/2中国烹饪/2八大菜系/浙菜
肉末烧茄	饮食/2烹饪/2中国烹饪/2八大菜系/浙菜
肉末烧茄子	饮食/2烹饪/2中国烹饪/2八大菜系/浙菜
肉棕鲈鱼	饮食/2烹饪/2中国烹饪/2八大菜系/浙菜
肉烧海带	饮食/2烹饪/2中国烹饪/2八大菜系/浙菜
肉烧白菜	饮食/2烹饪/2中国烹饪/2八大菜系/浙菜
肉片炒莴笋	饮食/2烹饪/2中国烹饪/2八大菜系/浙菜
肉片烧茄子	饮食/2烹饪/2中国烹饪/2八大菜系/浙菜
肉片焖扁豆	饮食/2烹饪/2中国烹饪/2八大菜系/浙菜
肉茸菠菜	饮食/2烹饪/2中国烹饪/2八大菜系/浙菜
肉蓉玉米羹	饮食/2烹饪/2中国烹饪/2八大菜系/浙菜
软炸冬瓜	饮食/2烹饪/2中国烹饪/2八大菜系/浙菜
软炸子鸡	饮食/2烹饪/2中国烹饪/2八大菜系/浙菜
软炸菜花	饮食/2烹饪/2中国烹饪/2八大菜系/浙菜
三丁大包	饮食/2烹饪/2中国烹饪/2八大菜系/浙菜
三丝敲鱼	饮食/2烹饪/2中国烹饪/2八大菜系/浙菜
三丝清炒蟹	饮食/2烹饪/2中国烹饪/2八大菜系/浙菜
三丝牛肉卷	饮食/2烹饪/2中国烹饪/2八大菜系/浙菜
三丝鱼卷	饮食/2烹饪/2中国烹饪/2八大菜系/浙菜
三味豆腐	饮食/2烹饪/2中国烹饪/2八大菜系/浙菜
三味黄瓜	饮食/2烹饪/2中国烹饪/2八大菜系/浙菜
三彩菠菜	饮食/2烹饪/2中国烹饪/2八大菜系/浙菜
三文一品汤包	饮食/2烹饪/2中国烹饪/2八大菜系/浙菜
三文鱼馅饺子	饮食/2烹饪/2中国烹饪/2八大菜系/浙菜
三皮丝上素仙鹤	饮食/2烹饪/2中国烹饪/2八大菜系/浙菜
三色蛋	饮食/2烹饪/2中国烹饪/2八大菜系/浙菜
三色鱼丸汤	饮食/2烹饪/2中国烹饪/2八大菜系/浙菜
三虾豆腐	饮食/2烹饪/2中国烹饪/2八大菜系/浙菜
三鲜冰豆腐	饮食/2烹饪/2中国烹饪/2八大菜系/浙菜
三鲜水饺	饮食/2烹饪/2中国烹饪/2八大菜系/浙菜
三鲜砂锅	饮食/2烹饪/2中国烹饪/2八大菜系/浙菜
三鲜苦瓜汤	饮食/2烹饪/2中国烹饪/2八大菜系/浙菜
三鲜茄子	饮食/2烹饪/2中国烹饪/2八大菜系/浙菜
三鲜蘑菇	饮食/2烹饪/2中国烹饪/2八大菜系/浙菜
三鲜蘑菰	饮食/2烹饪/2中国烹饪/2八大菜系/浙菜
三鲜豆腐	饮食/2烹饪/2中国烹饪/2八大菜系/浙菜
上素仙鹤	饮食/2烹饪/2中国烹饪/2八大菜系/浙菜
什锦暖锅	饮食/2烹饪/2中国烹饪/2八大菜系/浙菜
什锦水果羔	饮食/2烹饪/2中国烹饪/2八大菜系/浙菜
什锦肉丁	饮食/2烹饪/2中国烹饪/2八大菜系/浙菜
什锦豆腐	饮食/2烹饪/2中国烹饪/2八大菜系/浙菜
什锦锅巴	饮食/2烹饪/2中国烹饪/2八大菜系/浙菜
双味蝤蛑	饮食/2烹饪/2中国烹饪/2八大菜系/浙菜
双色芙蓉蛋	饮食/2烹饪/2中国烹饪/2八大菜系/浙菜
四喜丸子	饮食/2烹饪/2中国烹饪/2八大菜系/浙菜
四喜饺	饮食/2烹饪/2中国烹饪/2八大菜系/浙菜
四样荤素	饮食/2烹饪/2中国烹饪/2八大菜系/浙菜
四鲜烤麸	饮食/2烹饪/2中国烹饪/2八大菜系/浙菜
四鲜白菜墩	饮食/2烹饪/2中国烹饪/2八大菜系/浙菜
宋嫂鱼羹	饮食/2烹饪/2中国烹饪/2八大菜系/浙菜
寺院菜	饮食/2烹饪/2中国烹饪/2八大菜系/浙菜
山楂肉干	饮食/2烹饪/2中国烹饪/2八大菜系/浙菜
松子粥	饮食/2烹饪/2中国烹饪/2八大菜系/浙菜
松子肉	饮食/2烹饪/2中国烹饪/2八大菜系/浙菜
松鼠桂鱼	饮食/2烹饪/2中国烹饪/2八大菜系/浙菜
松鼠鳜鱼	饮食/2烹饪/2中国烹饪/2八大菜系/浙菜
水果塔	饮食/2烹饪/2中国烹饪/2八大菜系/浙菜
水炒鸡蛋	饮食/2烹饪/2中国烹饪/2八大菜系/浙菜
水饺豆沙煎饼	饮食/2烹饪/2中国烹饪/2八大菜系/浙菜
沙拉酱炒鱿鱼	饮食/2烹饪/2中国烹饪/2八大菜系/浙菜
沙拉酱炒鱿鱼卷	饮食/2烹饪/2中国烹饪/2八大菜系/浙菜
沙锅鱼	饮食/2烹饪/2中国烹饪/2八大菜系/浙菜
烧扒鱼脯	饮食/2烹饪/2中国烹饪/2八大菜系/浙菜
烧茄子	饮食/2烹饪/2中国烹饪/2八大菜系/浙菜
烧豆腐	饮食/2烹饪/2中国烹饪/2八大菜系/浙菜
烧香蘑	饮食/2烹饪/2中国烹饪/2八大菜系/浙菜
烧鸡丁辣子	饮食/2烹饪/2中国烹饪/2八大菜系/浙菜
珊瑚鱼丁	饮食/2烹饪/2中国烹饪/2八大菜系/浙菜
生抽王烧黄花鱼	饮食/2烹饪/2中国烹饪/2八大菜系/浙菜
生煎肉饼	饮食/2烹饪/2中国烹饪/2八大菜系/浙菜
生牛肉和粉	饮食/2烹饪/2中国烹饪/2八大菜系/浙菜
生牛肉河粉	饮食/2烹饪/2中国烹饪/2八大菜系/浙菜
砂窝鱼头豆腐	饮食/2烹饪/2中国烹饪/2八大菜系/浙菜
砂锅山海	饮食/2烹饪/2中国烹饪/2八大菜系/浙菜
砂锅鱼头豆腐	饮食/2烹饪/2中国烹饪/2八大菜系/浙菜
粟米粥	饮食/2烹饪/2中国烹饪/2八大菜系/浙菜
粟米菜花汤	饮食/2烹饪/2中国烹饪/2八大菜系/浙菜
粟米鲈鱼块	饮食/2烹饪/2中国烹饪/2八大菜系/浙菜
素炒茭白丝	饮食/2烹饪/2中国烹饪/2八大菜系/浙菜
素炒豇豆	饮食/2烹饪/2中国烹饪/2八大菜系/浙菜
素脆鳝	饮食/2烹饪/2中国烹饪/2八大菜系/浙菜
绍虾球	饮食/2烹饪/2中国烹饪/2八大菜系/浙菜
色香味俱全	饮食/2烹饪/2中国烹饪/2八大菜系/浙菜
荪角四宝汤	饮食/2烹饪/2中国烹饪/2八大菜系/浙菜
蒜泥茄子	饮食/2烹饪/2中国烹饪/2八大菜系/浙菜
蒜烧平菰	饮食/2烹饪/2中国烹饪/2八大菜系/浙菜
蒜苗炒虾	饮食/2烹饪/2中国烹饪/2八大菜系/浙菜
蒜茸豆腐菜胆	饮食/2烹饪/2中国烹饪/2八大菜系/浙菜
蒜蓉辣椒鲜鱿煲	饮食/2烹饪/2中国烹饪/2八大菜系/浙菜
蒜薹烧肉	饮食/2烹饪/2中国烹饪/2八大菜系/浙菜
蓑衣虾球	饮食/2烹饪/2中国烹饪/2八大菜系/浙菜
薯丁培根蛋	饮食/2烹饪/2中国烹饪/2八大菜系/浙菜
薯条手卷	饮食/2烹饪/2中国烹饪/2八大菜系/浙菜
酥小鲫鱼	饮食/2烹饪/2中国烹饪/2八大菜系/浙菜
酥炸嫩鸡	饮食/2烹饪/2中国烹饪/2八大菜系/浙菜
酥炸排骨	饮食/2烹饪/2中国烹饪/2八大菜系/浙菜
酥炸牛柳	饮食/2烹饪/2中国烹饪/2八大菜系/浙菜
酥炸牛肉卷	饮食/2烹饪/2中国烹饪/2八大菜系/浙菜
酥炸茄盒	饮食/2烹饪/2中国烹饪/2八大菜系/浙菜
酥炸香柠鸭	饮食/2烹饪/2中国烹饪/2八大菜系/浙菜
酥炸鸭子	饮食/2烹饪/2中国烹饪/2八大菜系/浙菜
酥蜜鲜果夹	饮食/2烹饪/2中国烹饪/2八大菜系/浙菜
酥香凤翅	饮食/2烹饪/2中国烹饪/2八大菜系/浙菜
酸菜藕片	饮食/2烹饪/2中国烹饪/2八大菜系/浙菜
酸豆角炒肉末	饮食/2烹饪/2中国烹饪/2八大菜系/浙菜
酸辣凤爪	饮食/2烹饪/2中国烹饪/2八大菜系/浙菜
酸辣瓜片	饮食/2烹饪/2中国烹饪/2八大菜系/浙菜
酸辣萝卜丝	饮食/2烹饪/2中国烹饪/2八大菜系/浙菜
酸辣虾仁烘蛋	饮食/2烹饪/2中国烹饪/2八大菜系/浙菜
酸辣青蚝	饮食/2烹饪/2中国烹饪/2八大菜系/浙菜
首乌炖蛋	饮食/2烹饪/2中国烹饪/2八大菜系/浙菜
兔肝鸡蛋汤	饮食/2烹饪/2中国烹饪/2八大菜系/浙菜
同心协力	饮食/2烹饪/2中国烹饪/2八大菜系/浙菜
土豆排骨汤	饮食/2烹饪/2中国烹饪/2八大菜系/浙菜
土豆炖牛肉	饮食/2烹饪/2中国烹饪/2八大菜系/浙菜
土豆烧肉	饮食/2烹饪/2中国烹饪/2八大菜系/浙菜
土豆饼	饮食/2烹饪/2中国烹饪/2八大菜系/浙菜
天麻鱼头	饮食/2烹饪/2中国烹饪/2八大菜系/浙菜
桃子色拉	饮食/2烹饪/2中国烹饪/2八大菜系/浙菜
桃梨焖牛肉丁	饮食/2烹饪/2中国烹饪/2八大菜系/浙菜
桃浆羹	饮食/2烹饪/2中国烹饪/2八大菜系/浙菜
桃花鸡腿	饮食/2烹饪/2中国烹饪/2八大菜系/浙菜
汀州伊面	饮食/2烹饪/2中国烹饪/2八大菜系/浙菜
甜椒南瓜汤	饮食/2烹饪/2中国烹饪/2八大菜系/浙菜
田园蘑菇沙拉	饮食/2烹饪/2中国烹饪/2八大菜系/浙菜
田园蘑菰沙拉	饮食/2烹饪/2中国烹饪/2八大菜系/浙菜
筒子肉	饮食/2烹饪/2中国烹饪/2八大菜系/浙菜
糖拌菜心	饮食/2烹饪/2中国烹饪/2八大菜系/浙菜
糖酱鱼	饮食/2烹饪/2中国烹饪/2八大菜系/浙菜
糖醋咕噜肉	饮食/2烹饪/2中国烹饪/2八大菜系/浙菜
糖醋小排	饮食/2烹饪/2中国烹饪/2八大菜系/浙菜
糖醋小萝卜	饮食/2烹饪/2中国烹饪/2八大菜系/浙菜
糖醋瓦块鱼	饮食/2烹饪/2中国烹饪/2八大菜系/浙菜
糖醋白菜	饮食/2烹饪/2中国烹饪/2八大菜系/浙菜
糖醋素排骨	饮食/2烹饪/2中国烹饪/2八大菜系/浙菜
糖醋红柿椒	饮食/2烹饪/2中国烹饪/2八大菜系/浙菜
糖醋莴笋	饮食/2烹饪/2中国烹饪/2八大菜系/浙菜
糖醋藕块	饮食/2烹饪/2中国烹饪/2八大菜系/浙菜
糖醋里嵴	饮食/2烹饪/2中国烹饪/2八大菜系/浙菜
糖醋面筋	饮食/2烹饪/2中国烹饪/2八大菜系/浙菜
糖醋鲜藕	饮食/2烹饪/2中国烹饪/2八大菜系/浙菜
糖醋鲤鱼	饮食/2烹饪/2中国烹饪/2八大菜系/浙菜
糖醋鸡块	饮食/2烹饪/2中国烹饪/2八大菜系/浙菜
腿茸上汤豆腐	饮食/2烹饪/2中国烹饪/2八大菜系/浙菜
苔菜小方烤	饮食/2烹饪/2中国烹饪/2八大菜系/浙菜
铁扒仔鸡	饮食/2烹饪/2中国烹饪/2八大菜系/浙菜
万子酥鸭	饮食/2烹饪/2中国烹饪/2八大菜系/浙菜
乌发汤	饮食/2烹饪/2中国烹饪/2八大菜系/浙菜
乌江豆腐鱼	饮食/2烹饪/2中国烹饪/2八大菜系/浙菜
五味汁炒茄子	饮食/2烹饪/2中国烹饪/2八大菜系/浙菜
五味煎蟹	饮食/2烹饪/2中国烹饪/2八大菜系/浙菜
五味白肉	饮食/2烹饪/2中国烹饪/2八大菜系/浙菜
五味鱿鱼	饮食/2烹饪/2中国烹饪/2八大菜系/浙菜
五夫醉鸡	饮食/2烹饪/2中国烹饪/2八大菜系/浙菜
五柳全鱼	饮食/2烹饪/2中国烹饪/2八大菜系/浙菜
五柳鱼	饮食/2烹饪/2中国烹饪/2八大菜系/浙菜
五柳鲜鱼	饮食/2烹饪/2中国烹饪/2八大菜系/浙菜
五色鱼丁	饮食/2烹饪/2中国烹饪/2八大菜系/浙菜
五谷蛋包饭	饮食/2烹饪/2中国烹饪/2八大菜系/浙菜
五香熏鸡蛋	饮食/2烹饪/2中国烹饪/2八大菜系/浙菜
五香狗肉	饮食/2烹饪/2中国烹饪/2八大菜系/浙菜
五香肥鸭	饮食/2烹饪/2中国烹饪/2八大菜系/浙菜
五香花生	饮食/2烹饪/2中国烹饪/2八大菜系/浙菜
五香苦瓜	饮食/2烹饪/2中国烹饪/2八大菜系/浙菜
无为熏鸭	饮食/2烹饪/2中国烹饪/2八大菜系/浙菜
煨烤桂鱼	饮食/2烹饪/2中国烹饪/2八大菜系/浙菜
瓦煲鸡饭	饮食/2烹饪/2中国烹饪/2八大菜系/浙菜
莴笋拌白肉	饮食/2烹饪/2中国烹饪/2八大菜系/浙菜
豌豆粥	饮食/2烹饪/2中国烹饪/2八大菜系/浙菜
咸菜大汤黄鱼	饮食/2烹饪/2中国烹饪/2八大菜系/浙菜
咸菜肉丝毛豆	饮食/2烹饪/2中国烹饪/2八大菜系/浙菜
小笼粉蒸牛肉	饮食/2烹饪/2中国烹饪/2八大菜系/浙菜
小蒸包	饮食/2烹饪/2中国烹饪/2八大菜系/浙菜
星州炒米粉	饮食/2烹饪/2中国烹饪/2八大菜系/浙菜
杏仁炖肉	饮食/2烹饪/2中国烹饪/2八大菜系/浙菜
杏仁猪肺汤	饮食/2烹饪/2中国烹饪/2八大菜系/浙菜
杏仁豆腐	饮食/2烹饪/2中国烹饪/2八大菜系/浙菜
细沙羊尾	饮食/2烹饪/2中国烹饪/2八大菜系/浙菜
绣球薯圆	饮食/2烹饪/2中国烹饪/2八大菜系/浙菜
虾仁拌莼菜	饮食/2烹饪/2中国烹饪/2八大菜系/浙菜
虾仁烘蛋	饮食/2烹饪/2中国烹饪/2八大菜系/浙菜
虾仁玉子豆腐	饮食/2烹饪/2中国烹饪/2八大菜系/浙菜
虾子茄段	饮食/2烹饪/2中国烹饪/2八大菜系/浙菜
虾油鸡	饮食/2烹饪/2中国烹饪/2八大菜系/浙菜
虾米拌豆腐	饮食/2烹饪/2中国烹饪/2八大菜系/浙菜
虾茸酿面包	饮食/2烹饪/2中国烹饪/2八大菜系/浙菜
蟹盖沙律	饮食/2烹饪/2中国烹饪/2八大菜系/浙菜
蟹粉西兰花	饮食/2烹饪/2中国烹饪/2八大菜系/浙菜
蟹粉鱼翅	饮食/2烹饪/2中国烹饪/2八大菜系/浙菜
蟹肉西兰花	饮食/2烹饪/2中国烹饪/2八大菜系/浙菜
蟹镶橙	饮食/2烹饪/2中国烹饪/2八大菜系/浙菜
蟹黄灌汤包	饮食/2烹饪/2中国烹饪/2八大菜系/浙菜
蟹黄肉包	饮食/2烹饪/2中国烹饪/2八大菜系/浙菜
西兰花	饮食/2烹饪/2中国烹饪/2八大菜系/浙菜
西洋烩鸡	饮食/2烹饪/2中国烹饪/2八大菜系/浙菜
西湖桂花藕粉	饮食/2烹饪/2中国烹饪/2八大菜系/浙菜
西湖莼菜汤	饮食/2烹饪/2中国烹饪/2八大菜系/浙菜
西湖莼菜羹	饮食/2烹饪/2中国烹饪/2八大菜系/浙菜
西湖醋	饮食/2烹饪/2中国烹饪/2八大菜系/浙菜
西湖醋鱼	饮食/2烹饪/2中国烹饪/2八大菜系/浙菜
西红柿牛肉汤	饮食/2烹饪/2中国烹饪/2八大菜系/浙菜
西芹鸡肫	饮食/2烹饪/2中国烹饪/2八大菜系/浙菜
象牙步鱼	饮食/2烹饪/2中国烹饪/2八大菜系/浙菜
醒胃腌椰菜花	饮食/2烹饪/2中国烹饪/2八大菜系/浙菜
雪梗珍珠羹	饮食/2烹饪/2中国烹饪/2八大菜系/浙菜
雪花豆腐	饮食/2烹饪/2中国烹饪/2八大菜系/浙菜
雪花豆腐羹	饮食/2烹饪/2中国烹饪/2八大菜系/浙菜
雪花鱼丝羹	饮食/2烹饪/2中国烹饪/2八大菜系/浙菜
雪菜大汤黄鱼	饮食/2烹饪/2中国烹饪/2八大菜系/浙菜
雪菜肉丝	饮食/2烹饪/2中国烹饪/2八大菜系/浙菜
雪菜苦瓜	饮食/2烹饪/2中国烹饪/2八大菜系/浙菜
香卤猪肘	饮食/2烹饪/2中国烹饪/2八大菜系/浙菜
香柠佛手鱼	饮食/2烹饪/2中国烹饪/2八大菜系/浙菜
香椿烘蛋	饮食/2烹饪/2中国烹饪/2八大菜系/浙菜
香橙糕	饮食/2烹饪/2中国烹饪/2八大菜系/浙菜
香油金瓜丝	饮食/2烹饪/2中国烹饪/2八大菜系/浙菜
香肠烧菜花	饮食/2烹饪/2中国烹饪/2八大菜系/浙菜
香茹炒青菜	饮食/2烹饪/2中国烹饪/2八大菜系/浙菜
香菇素鸡	饮食/2烹饪/2中国烹饪/2八大菜系/浙菜
香菇茭白汤	饮食/2烹饪/2中国烹饪/2八大菜系/浙菜
香菇西兰花	饮食/2烹饪/2中国烹饪/2八大菜系/浙菜
香菇豆角	饮食/2烹饪/2中国烹饪/2八大菜系/浙菜
香菜梗炒鳝丝	饮食/2烹饪/2中国烹饪/2八大菜系/浙菜
香菰烧丝瓜	饮食/2烹饪/2中国烹饪/2八大菜系/浙菜
香菰烧菜心	饮食/2烹饪/2中国烹饪/2八大菜系/浙菜
香菰素鸡	饮食/2烹饪/2中国烹饪/2八大菜系/浙菜
香菰茭白汤	饮食/2烹饪/2中国烹饪/2八大菜系/浙菜
香菰西兰花	饮食/2烹饪/2中国烹饪/2八大菜系/浙菜
香菰豆角	饮食/2烹饪/2中国烹饪/2八大菜系/浙菜
香菰里嵴	饮食/2烹饪/2中国烹饪/2八大菜系/浙菜
香葱烘蛋	饮食/2烹饪/2中国烹饪/2八大菜系/浙菜
香蕉粥	饮食/2烹饪/2中国烹饪/2八大菜系/浙菜
香蕉肉脯	饮食/2烹饪/2中国烹饪/2八大菜系/浙菜
香蕉西米羹	饮食/2烹饪/2中国烹饪/2八大菜系/浙菜
香辣咖哩面包	饮食/2烹饪/2中国烹饪/2八大菜系/浙菜
香酥冬瓜	饮食/2烹饪/2中国烹饪/2八大菜系/浙菜
香酥填鸭	饮食/2烹饪/2中国烹饪/2八大菜系/浙菜
香鱼白菜	饮食/2烹饪/2中国烹饪/2八大菜系/浙菜
鲜杞炒里嵴片	饮食/2烹饪/2中国烹饪/2八大菜系/浙菜
鲜杞炒里脊片	饮食/2烹饪/2中国烹饪/2八大菜系/浙菜
鲜果明珠羹	饮食/2烹饪/2中国烹饪/2八大菜系/浙菜
鲜果银耳	饮食/2烹饪/2中国烹饪/2八大菜系/浙菜
鲜柠脆虾球	饮食/2烹饪/2中国烹饪/2八大菜系/浙菜
鲜荷叶鸡蒸粉	饮食/2烹饪/2中国烹饪/2八大菜系/浙菜
鲜莲炒子鸡	饮食/2烹饪/2中国烹饪/2八大菜系/浙菜
鲜菇鱼片	饮食/2烹饪/2中国烹饪/2八大菜系/浙菜
鲜菰鱼片	饮食/2烹饪/2中国烹饪/2八大菜系/浙菜
鲜蘑火冬瓜	饮食/2烹饪/2中国烹饪/2八大菜系/浙菜
鲜蘑炒肉片	饮食/2烹饪/2中国烹饪/2八大菜系/浙菜
鲜蘑菇炖豆腐	饮食/2烹饪/2中国烹饪/2八大菜系/浙菜
鲜蘑菰炖豆腐	饮食/2烹饪/2中国烹饪/2八大菜系/浙菜
鲜蘑蒸鸡	饮食/2烹饪/2中国烹饪/2八大菜系/浙菜
鲜蘑豆腐	饮食/2烹饪/2中国烹饪/2八大菜系/浙菜
鲜虾扒豆苗	饮食/2烹饪/2中国烹饪/2八大菜系/浙菜
一品薯包	饮食/2烹饪/2中国烹饪/2八大菜系/浙菜
一品酱羊肉	饮食/2烹饪/2中国烹饪/2八大菜系/浙菜
云猪手	饮食/2烹饪/2中国烹饪/2八大菜系/浙菜
云耳番茄汤	饮食/2烹饪/2中国烹饪/2八大菜系/浙菜
云耳西芹炒肉片	饮食/2烹饪/2中国烹饪/2八大菜系/浙菜
元蹄炖鸡	饮食/2烹饪/2中国烹饪/2八大菜系/浙菜
养生菜根	饮食/2烹饪/2中国烹饪/2八大菜系/浙菜
圆葱饭团	饮食/2烹饪/2中国烹饪/2八大菜系/浙菜
杨梅丸子	饮食/2烹饪/2中国烹饪/2八大菜系/浙菜
杨梅肉丸	饮食/2烹饪/2中国烹饪/2八大菜系/浙菜
椰汁水晶冻	饮食/2烹饪/2中国烹饪/2八大菜系/浙菜
椰菜烟肉汤	饮食/2烹饪/2中国烹饪/2八大菜系/浙菜
樱桃土豆	饮食/2烹饪/2中国烹饪/2八大菜系/浙菜
樱桃糖酒汁	饮食/2烹饪/2中国烹饪/2八大菜系/浙菜
樱桃肉	饮食/2烹饪/2中国烹饪/2八大菜系/浙菜
油吃麻辣茭白	饮食/2烹饪/2中国烹饪/2八大菜系/浙菜
油拌酥瓜条	饮食/2烹饪/2中国烹饪/2八大菜系/浙菜
油条青菜	饮食/2烹饪/2中国烹饪/2八大菜系/浙菜
油泡腰花	饮食/2烹饪/2中国烹饪/2八大菜系/浙菜
油浸鸡	饮食/2烹饪/2中国烹饪/2八大菜系/浙菜
油淋鸡	饮食/2烹饪/2中国烹饪/2八大菜系/浙菜
油烫茭白	饮食/2烹饪/2中国烹饪/2八大菜系/浙菜
油焖春笋	饮食/2烹饪/2中国烹饪/2八大菜系/浙菜
油焖海明虾	饮食/2烹饪/2中国烹饪/2八大菜系/浙菜
油焖白菜	饮食/2烹饪/2中国烹饪/2八大菜系/浙菜
油焖苦瓜	饮食/2烹饪/2中国烹饪/2八大菜系/浙菜
油焖虾	饮食/2烹饪/2中国烹饪/2八大菜系/浙菜
油煎糖年糕	饮食/2烹饪/2中国烹饪/2八大菜系/浙菜
油煎茄片	饮食/2烹饪/2中国烹饪/2八大菜系/浙菜
油爆笋丁	饮食/2烹饪/2中国烹饪/2八大菜系/浙菜
油爆肚仁	饮食/2烹饪/2中国烹饪/2八大菜系/浙菜
油爆鱿鱼卷	饮食/2烹饪/2中国烹饪/2八大菜系/浙菜
油闷春笋	饮食/2烹饪/2中国烹饪/2八大菜系/浙菜
洋白菜鲜虾包	饮食/2烹饪/2中国烹饪/2八大菜系/浙菜
洋葱炒蛋	饮食/2烹饪/2中国烹饪/2八大菜系/浙菜
洋葱炒鳝煳	饮食/2烹饪/2中国烹饪/2八大菜系/浙菜
洋葱炒鳝糊	饮食/2烹饪/2中国烹饪/2八大菜系/浙菜
洋葱酱	饮食/2烹饪/2中国烹饪/2八大菜系/浙菜
燕巢凤尾虾	饮食/2烹饪/2中国烹饪/2八大菜系/浙菜
玉兔五彩丝	饮食/2烹饪/2中国烹饪/2八大菜系/浙菜
玉兰明虾	饮食/2烹饪/2中国烹饪/2八大菜系/浙菜
玉簪里嵴	饮食/2烹饪/2中国烹饪/2八大菜系/浙菜
玉簪里脊	饮食/2烹饪/2中国烹饪/2八大菜系/浙菜
玉米色拉	饮食/2烹饪/2中国烹饪/2八大菜系/浙菜
盐水鸭亲	饮食/2烹饪/2中国烹饪/2八大菜系/浙菜
腰果鸡丁	饮食/2烹饪/2中国烹饪/2八大菜系/浙菜
越式凉拌鸡丝	饮食/2烹饪/2中国烹饪/2八大菜系/浙菜
银牙韭菜花	饮食/2烹饪/2中国烹饪/2八大菜系/浙菜
银耳陈皮炖乳鸽	饮食/2烹饪/2中国烹饪/2八大菜系/浙菜
银芽韭菜花	饮食/2烹饪/2中国烹饪/2八大菜系/浙菜
鱼片蒸蛋	饮食/2烹饪/2中国烹饪/2八大菜系/浙菜
鱼珊瑚	饮食/2烹饪/2中国烹饪/2八大菜系/浙菜
鱼肉土豆	饮食/2烹饪/2中国烹饪/2八大菜系/浙菜
鱼蓉熘面包	饮食/2烹饪/2中国烹饪/2八大菜系/浙菜
鱼酸汤	饮食/2烹饪/2中国烹饪/2八大菜系/浙菜
鱼香全茄	饮食/2烹饪/2中国烹饪/2八大菜系/浙菜
鱼香炒蛋	饮食/2烹饪/2中国烹饪/2八大菜系/浙菜
鱼香苦瓜	饮食/2烹饪/2中国烹饪/2八大菜系/浙菜
鱼香茄子	饮食/2烹饪/2中国烹饪/2八大菜系/浙菜
鱼香茄条	饮食/2烹饪/2中国烹饪/2八大菜系/浙菜
鱼香茄饼	饮食/2烹饪/2中国烹饪/2八大菜系/浙菜
鱼香荷包蛋	饮食/2烹饪/2中国烹饪/2八大菜系/浙菜
鱼香菜心	饮食/2烹饪/2中国烹饪/2八大菜系/浙菜
鱼香豇豆	饮食/2烹饪/2中国烹饪/2八大菜系/浙菜
鱿鱼烩杨桃	饮食/2烹饪/2中国烹饪/2八大菜系/浙菜
之江鲈莼羹	饮食/2烹饪/2中国烹饪/2八大菜系/浙菜
子鱼勒丸子汤	饮食/2烹饪/2中国烹饪/2八大菜系/浙菜
孜然羊肉	饮食/2烹饪/2中国烹饪/2八大菜系/浙菜
张一品酱羊肉	饮食/2烹饪/2中国烹饪/2八大菜系/浙菜
抓炒里嵴	饮食/2烹饪/2中国烹饪/2八大菜系/浙菜
斩鱼圆	饮食/2烹饪/2中国烹饪/2八大菜系/浙菜
枣莲炖雪哈	饮食/2烹饪/2中国烹饪/2八大菜系/浙菜
柱侯煎鱼排	饮食/2烹饪/2中国烹饪/2八大菜系/浙菜
植物扒四宝	饮食/2烹饪/2中国烹饪/2八大菜系/浙菜
榨菜炒鸡柳	饮食/2烹饪/2中国烹饪/2八大菜系/浙菜
榨菜蒸大鳝	饮食/2烹饪/2中国烹饪/2八大菜系/浙菜
浙菜黄焖鸭腰管廷	饮食/2烹饪/2中国烹饪/2八大菜系/浙菜
炸冬瓜丸子	饮食/2烹饪/2中国烹饪/2八大菜系/浙菜
炸卷肝	饮食/2烹饪/2中国烹饪/2八大菜系/浙菜
炸土豆球	饮食/2烹饪/2中国烹饪/2八大菜系/浙菜
炸熘樱桃圆	饮食/2烹饪/2中国烹饪/2八大菜系/浙菜
炸熘黄鱼	饮食/2烹饪/2中国烹饪/2八大菜系/浙菜
炸糯米鸡	饮食/2烹饪/2中国烹饪/2八大菜系/浙菜
炸糯米鸡(八宝糯米鸡	饮食/2烹饪/2中国烹饪/2八大菜系/浙菜
炸羊尾	饮食/2烹饪/2中国烹饪/2八大菜系/浙菜
炸茄饼	饮食/2烹饪/2中国烹饪/2八大菜系/浙菜
炸藕盒	饮食/2烹饪/2中国烹饪/2八大菜系/浙菜
炸虾饼	饮食/2烹饪/2中国烹饪/2八大菜系/浙菜
炸豆腐芝士	饮食/2烹饪/2中国烹饪/2八大菜系/浙菜
炸馄饨	饮食/2烹饪/2中国烹饪/2八大菜系/浙菜
炸鱼丸	饮食/2烹饪/2中国烹饪/2八大菜系/浙菜
炸鱼卷	饮食/2烹饪/2中国烹饪/2八大菜系/浙菜
炸鳝段	饮食/2烹饪/2中国烹饪/2八大菜系/浙菜
炸鸡椒	饮食/2烹饪/2中国烹饪/2八大菜系/浙菜
炸鸡肉串	饮食/2烹饪/2中国烹饪/2八大菜系/浙菜
状元卤味	饮食/2烹饪/2中国烹饪/2八大菜系/浙菜
猪尾浓汤	饮食/2烹饪/2中国烹饪/2八大菜系/浙菜
竹笋芋艿鲫鱼汤	饮食/2烹饪/2中国烹饪/2八大菜系/浙菜
竹荪鸽蛋汤	饮食/2烹饪/2中国烹饪/2八大菜系/浙菜
糟油青鱼划水	饮食/2烹饪/2中国烹饪/2八大菜系/浙菜
糟烩鞭笋	饮食/2烹饪/2中国烹饪/2八大菜系/浙菜
糟香鱼头云	饮食/2烹饪/2中国烹饪/2八大菜系/浙菜
糟鸡	饮食/2烹饪/2中国烹饪/2八大菜系/浙菜
芝麻小白菜	饮食/2烹饪/2中国烹饪/2八大菜系/浙菜
芝麻桂鱼	饮食/2烹饪/2中国烹饪/2八大菜系/浙菜
芝麻肉片	饮食/2烹饪/2中国烹饪/2八大菜系/浙菜
蒸鲳鱼	饮食/2烹饪/2中国烹饪/2八大菜系/浙菜
走油肉	饮食/2烹饪/2中国烹饪/2八大菜系/浙菜
醉活虾	饮食/2烹饪/2中国烹饪/2八大菜系/浙菜
醉鸡	饮食/2烹饪/2中国烹饪/2八大菜系/浙菜
镇江肴肉	饮食/2烹饪/2中国烹饪/2八大菜系/浙菜
鏊锅油鸡	饮食/2烹饪/2中国烹饪/2八大菜系/苏菜
八宝菠菜	饮食/2烹饪/2中国烹饪/2八大菜系/苏菜
八宝豆腐箱	饮食/2烹饪/2中国烹饪/2八大菜系/苏菜
八宝酿香瓜	饮食/2烹饪/2中国烹饪/2八大菜系/苏菜
八宝鼋鱼	饮食/2烹饪/2中国烹饪/2八大菜系/苏菜
扁大枯酥	饮食/2烹饪/2中国烹饪/2八大菜系/苏菜
扒三白	饮食/2烹饪/2中国烹饪/2八大菜系/苏菜
扒原壳鲍鱼	饮食/2烹饪/2中国烹饪/2八大菜系/苏菜
扒方肉	饮食/2烹饪/2中国烹饪/2八大菜系/苏菜
扒牛肉条	饮食/2烹饪/2中国烹饪/2八大菜系/苏菜
扒鲍鱼芦笋	饮食/2烹饪/2中国烹饪/2八大菜系/苏菜
拌肘子	饮食/2烹饪/2中国烹饪/2八大菜系/苏菜
拔丝楂糕	饮食/2烹饪/2中国烹饪/2八大菜系/苏菜
拔丝苹果	饮食/2烹饪/2中国烹饪/2八大菜系/苏菜
拔丝金枣	饮食/2烹饪/2中国烹饪/2八大菜系/苏菜
爆氽	饮食/2烹饪/2中国烹饪/2八大菜系/苏菜
爆鱼丁	饮食/2烹饪/2中国烹饪/2八大菜系/苏菜
白扒猴头	饮食/2烹饪/2中国烹饪/2八大菜系/苏菜
白扒通天鱼翅	饮食/2烹饪/2中国烹饪/2八大菜系/苏菜
白斩鸡	饮食/2烹饪/2中国烹饪/2八大菜系/苏菜
白汁乳狗	饮食/2烹饪/2中国烹饪/2八大菜系/苏菜
白汁回鱼	饮食/2烹饪/2中国烹饪/2八大菜系/苏菜
白汁圆菜	饮食/2烹饪/2中国烹饪/2八大菜系/苏菜
白汁鮰鱼	饮食/2烹饪/2中国烹饪/2八大菜系/苏菜
白汁鼋量	饮食/2烹饪/2中国烹饪/2八大菜系/苏菜
白炒刀鱼丝	饮食/2烹饪/2中国烹饪/2八大菜系/苏菜
白烧四宝	饮食/2烹饪/2中国烹饪/2八大菜系/苏菜
白酥鸡	饮食/2烹饪/2中国烹饪/2八大菜系/苏菜
百果玫瑰球	饮食/2烹饪/2中国烹饪/2八大菜系/苏菜
百花酒焖肉	饮食/2烹饪/2中国烹饪/2八大菜系/苏菜
饼子野鸭	饮食/2烹饪/2中国烹饪/2八大菜系/苏菜
鲍鱼鸡翼	饮食/2烹饪/2中国烹饪/2八大菜系/苏菜
板桥宴	饮食/2烹饪/2中国烹饪/2八大菜系/苏菜
碧玉三珠	饮食/2烹饪/2中国烹饪/2八大菜系/苏菜
串肉意大利面	饮食/2烹饪/2中国烹饪/2八大菜系/苏菜
叉烤酥方	饮食/2烹饪/2中国烹饪/2八大菜系/苏菜
叉烤野鸡片	饮食/2烹饪/2中国烹饪/2八大菜系/苏菜
叉烤鳜鱼	饮食/2烹饪/2中国烹饪/2八大菜系/苏菜
叉烧野鸡	饮食/2烹饪/2中国烹饪/2八大菜系/苏菜
拆冻鲫鱼	饮食/2烹饪/2中国烹饪/2八大菜系/苏菜
拆烩野鸭	饮食/2烹饪/2中国烹饪/2八大菜系/苏菜
拆烩鲢鱼头	饮食/2烹饪/2中国烹饪/2八大菜系/苏菜
拆骨掌翅	饮食/2烹饪/2中国烹饪/2八大菜系/苏菜
春笋白拌鸡	饮食/2烹饪/2中国烹饪/2八大菜系/苏菜
炒碧桃里脊	饮食/2烹饪/2中国烹饪/2八大菜系/苏菜
炒肉拉皮	饮食/2烹饪/2中国烹饪/2八大菜系/苏菜
炒血糯	饮食/2烹饪/2中国烹饪/2八大菜系/苏菜
炒铁雀头脯	饮食/2烹饪/2中国烹饪/2八大菜系/苏菜
炒鸡丝	饮食/2烹饪/2中国烹饪/2八大菜系/苏菜
脆炸卤肉血皮菜	饮食/2烹饪/2中国烹饪/2八大菜系/苏菜
脆皮卷	饮食/2烹饪/2中国烹饪/2八大菜系/苏菜
脆鱼拌干丝	饮食/2烹饪/2中国烹饪/2八大菜系/苏菜
茶叶熏鸡	饮食/2烹饪/2中国烹饪/2八大菜系/苏菜
茶汁炖元宝	饮食/2烹饪/2中国烹饪/2八大菜系/苏菜
葱根肴	饮食/2烹饪/2中国烹饪/2八大菜系/苏菜
葱油拌双耳	饮食/2烹饪/2中国烹饪/2八大菜系/苏菜
葱油鱼	饮食/2烹饪/2中国烹饪/2八大菜系/苏菜
葱辣鲜虾	饮食/2烹饪/2中国烹饪/2八大菜系/苏菜
藏式咖喱牛肉	饮食/2烹饪/2中国烹饪/2八大菜系/苏菜
醋椒桂鱼	饮食/2烹饪/2中国烹饪/2八大菜系/苏菜
醋熘鳜鱼	饮食/2烹饪/2中国烹饪/2八大菜系/苏菜
葱蒸干贝	饮食/2烹饪/2中国烹饪/2八大菜系/苏菜
叉烧鸭子	饮食/2烹饪/2中国烹饪/2八大菜系/苏菜
东坡狗肉	饮食/2烹饪/2中国烹饪/2八大菜系/苏菜
冬瓜四灵	饮食/2烹饪/2中国烹饪/2八大菜系/苏菜
冬瓜鸡方	饮食/2烹饪/2中国烹饪/2八大菜系/苏菜
冬菇笋炖老豆腐	饮食/2烹饪/2中国烹饪/2八大菜系/苏菜
大烧马鞍桥	饮食/2烹饪/2中国烹饪/2八大菜系/苏菜
大煮干丝	饮食/2烹饪/2中国烹饪/2八大菜系/苏菜
淡菜皱纹肉	饮食/2烹饪/2中国烹饪/2八大菜系/苏菜
炖家野	饮食/2烹饪/2中国烹饪/2八大菜系/苏菜
炖炆武鸭	饮食/2烹饪/2中国烹饪/2八大菜系/苏菜
蛋梅鸡	饮食/2烹饪/2中国烹饪/2八大菜系/苏菜
豆苗山鸡片	饮食/2烹饪/2中国烹饪/2八大菜系/苏菜
豆茸酿枇杷	饮食/2烹饪/2中国烹饪/2八大菜系/苏菜
豆鼓肉	饮食/2烹饪/2中国烹饪/2八大菜系/苏菜
东坡回赠肉	饮食/2烹饪/2中国烹饪/2八大菜系/苏菜
凤尾虾	饮食/2烹饪/2中国烹饪/2八大菜系/苏菜
发菜龙眼	饮食/2烹饪/2中国烹饪/2八大菜系/苏菜
富春鸡	饮食/2烹饪/2中国烹饪/2八大菜系/苏菜
甫里鸭羹	饮食/2烹饪/2中国烹饪/2八大菜系/苏菜
番茄松鼠鱼	饮食/2烹饪/2中国烹饪/2八大菜系/苏菜
粉蒸回鱼	饮食/2烹饪/2中国烹饪/2八大菜系/苏菜
腐乳汁肉	饮食/2烹饪/2中国烹饪/2八大菜系/苏菜
腐乳炝虾	饮食/2烹饪/2中国烹饪/2八大菜系/苏菜
腐乳醉虾	饮食/2烹饪/2中国烹饪/2八大菜系/苏菜
芙蓉干贝	饮食/2烹饪/2中国烹饪/2八大菜系/苏菜
芙蓉黄管	饮食/2烹饪/2中国烹饪/2八大菜系/苏菜
风蹄	饮食/2烹饪/2中国烹饪/2八大菜系/苏菜
风鸡斩肉	饮食/2烹饪/2中国烹饪/2八大菜系/苏菜
凤蹄	饮食/2烹饪/2中国烹饪/2八大菜系/苏菜
干煸肉丝	饮食/2烹饪/2中国烹饪/2八大菜系/苏菜
干风春鱼	饮食/2烹饪/2中国烹饪/2八大菜系/苏菜
果味山药泥	饮食/2烹饪/2中国烹饪/2八大菜系/苏菜
果珍薯丁	饮食/2烹饪/2中国烹饪/2八大菜系/苏菜
桂花糖大栗	饮食/2烹饪/2中国烹饪/2八大菜系/苏菜
灌蟹鱼圆	饮食/2烹饪/2中国烹饪/2八大菜系/苏菜
贡淡炖鸭	饮食/2烹饪/2中国烹饪/2八大菜系/苏菜
锅塌鲜蛏	饮食/2烹饪/2中国烹饪/2八大菜系/苏菜
锅塌鸡签	饮食/2烹饪/2中国烹饪/2八大菜系/苏菜
锅巴虾仁	饮食/2烹饪/2中国烹饪/2八大菜系/苏菜
锅炸鸭方	饮食/2烹饪/2中国烹饪/2八大菜系/苏菜
锅烧肉	饮食/2烹饪/2中国烹饪/2八大菜系/苏菜
锅烧肘子	饮食/2烹饪/2中国烹饪/2八大菜系/苏菜
锅煎鳜鱼	饮食/2烹饪/2中国烹饪/2八大菜系/苏菜
锅煸豆腐	饮食/2烹饪/2中国烹饪/2八大菜系/苏菜
锅煽鱼扇	饮食/2烹饪/2中国烹饪/2八大菜系/苏菜
锅鳎鱼盒	饮食/2烹饪/2中国烹饪/2八大菜系/苏菜
高沟捆蹄	饮食/2烹饪/2中国烹饪/2八大菜系/苏菜
回赠肉	饮食/2烹饪/2中国烹饪/2八大菜系/苏菜
海参肘子	饮食/2烹饪/2中国烹饪/2八大菜系/苏菜
海带炖鸭	饮食/2烹饪/2中国烹饪/2八大菜系/苏菜
海底松银肺	饮食/2烹饪/2中国烹饪/2八大菜系/苏菜
海鲜锅	饮食/2烹饪/2中国烹饪/2八大菜系/苏菜
淮扬菜	饮食/2烹饪/2中国烹饪/2八大菜系/苏菜
火烧马鞍桥	饮食/2烹饪/2中国烹饪/2八大菜系/苏菜
烩乌鱼蛋	饮食/2烹饪/2中国烹饪/2八大菜系/苏菜
红松鳜鱼	饮食/2烹饪/2中国烹饪/2八大菜系/苏菜
红烧沙光鱼	饮食/2烹饪/2中国烹饪/2八大菜系/苏菜
红烧肉	饮食/2烹饪/2中国烹饪/2八大菜系/苏菜
红薯粑	饮食/2烹饪/2中国烹饪/2八大菜系/苏菜
红鱼拜年	饮食/2烹饪/2中国烹饪/2八大菜系/苏菜
花揽桂鱼	饮食/2烹饪/2中国烹饪/2八大菜系/苏菜
花篮拼盘	饮食/2烹饪/2中国烹饪/2八大菜系/苏菜
花菇田鸡	饮食/2烹饪/2中国烹饪/2八大菜系/苏菜
荷叶局鸡	饮食/2烹饪/2中国烹饪/2八大菜系/苏菜
荷叶粉蒸鸡	饮食/2烹饪/2中国烹饪/2八大菜系/苏菜
荷花白嫩鸡	饮食/2烹饪/2中国烹饪/2八大菜系/苏菜
荷花铁雀	饮食/2烹饪/2中国烹饪/2八大菜系/苏菜
荷花集锦炖	饮食/2烹饪/2中国烹饪/2八大菜系/苏菜
葫芦虾蟹	饮食/2烹饪/2中国烹饪/2八大菜系/苏菜
虎皮肘子	饮食/2烹饪/2中国烹饪/2八大菜系/苏菜
蚝油凤翼	饮食/2烹饪/2中国烹饪/2八大菜系/苏菜
蝴蝶采花	饮食/2烹饪/2中国烹饪/2八大菜系/苏菜
还丝汤	饮食/2烹饪/2中国烹饪/2八大菜系/苏菜
黄泥煨鸡	饮食/2烹饪/2中国烹饪/2八大菜系/苏菜
黄焖着甲	饮食/2烹饪/2中国烹饪/2八大菜系/苏菜
黄鱼豆腐羹	饮食/2烹饪/2中国烹饪/2八大菜系/苏菜
海味香盏	饮食/2烹饪/2中国烹饪/2八大菜系/苏菜
红烧大乌	饮食/2烹饪/2中国烹饪/2八大菜系/苏菜
京葱炆牛方	饮食/2烹饪/2中国烹饪/2八大菜系/苏菜
夹心虾糕	饮食/2烹饪/2中国烹饪/2八大菜系/苏菜
姜豉	饮食/2烹饪/2中国烹饪/2八大菜系/苏菜
椒油扁豆	饮食/2烹饪/2中国烹饪/2八大菜系/苏菜
椒盐塘鱼片	饮食/2烹饪/2中国烹饪/2八大菜系/苏菜
橘味海带丝	饮食/2烹饪/2中国烹饪/2八大菜系/苏菜
焦馏里脊	饮食/2烹饪/2中国烹饪/2八大菜系/苏菜
胶东豆腐蟹	饮食/2烹饪/2中国烹饪/2八大菜系/苏菜
菊叶玉板	饮食/2烹饪/2中国烹饪/2八大菜系/苏菜
酒凝金腿	饮食/2烹饪/2中国烹饪/2八大菜系/苏菜
酒糟大蛏	饮食/2烹饪/2中国烹饪/2八大菜系/苏菜
酒蒸全鸡汤	饮食/2烹饪/2中国烹饪/2八大菜系/苏菜
酒酿金腿	饮食/2烹饪/2中国烹饪/2八大菜系/苏菜
酱方	饮食/2烹饪/2中国烹饪/2八大菜系/苏菜
酱汁排骨	饮食/2烹饪/2中国烹饪/2八大菜系/苏菜
酱汁肉	饮食/2烹饪/2中国烹饪/2八大菜系/苏菜
酱爆肉丁	饮食/2烹饪/2中国烹饪/2八大菜系/苏菜
金橘肉	饮食/2烹饪/2中国烹饪/2八大菜系/苏菜
金腿脊梅炖腰酥	饮食/2烹饪/2中国烹饪/2八大菜系/苏菜
金茹烧肥牛	饮食/2烹饪/2中国烹饪/2八大菜系/苏菜
金钱饼	饮食/2烹饪/2中国烹饪/2八大菜系/苏菜
金陵丸子	饮食/2烹饪/2中国烹饪/2八大菜系/苏菜
金陵圆子	饮食/2烹饪/2中国烹饪/2八大菜系/苏菜
金陵板鸭	饮食/2烹饪/2中国烹饪/2八大菜系/苏菜
金陵烤鸭	饮食/2烹饪/2中国烹饪/2八大菜系/苏菜
鸡汁干丝	饮食/2烹饪/2中国烹饪/2八大菜系/苏菜
鸡汤煮干丝	饮食/2烹饪/2中国烹饪/2八大菜系/苏菜
鸡火鱼鲞	饮食/2烹饪/2中国烹饪/2八大菜系/苏菜
鸡粥菜心	饮食/2烹饪/2中国烹饪/2八大菜系/苏菜
鸡粥鱼肚	饮食/2烹饪/2中国烹饪/2八大菜系/苏菜
鸡肉糁	饮食/2烹饪/2中国烹饪/2八大菜系/苏菜
鸡茸干贝	饮食/2烹饪/2中国烹饪/2八大菜系/苏菜
金蒜银鱼蒸菜心	饮食/2烹饪/2中国烹饪/2八大菜系/苏菜
京苏大菜	饮食/2烹饪/2中国烹饪/2八大菜系/苏菜
咖喱蔬菜鱼丸煲	饮食/2烹饪/2中国烹饪/2八大菜系/苏菜
烤小鸡	饮食/2烹饪/2中国烹饪/2八大菜系/苏菜
烤方	饮食/2烹饪/2中国烹饪/2八大菜系/苏菜
烤炖鸭子	饮食/2烹饪/2中国烹饪/2八大菜系/苏菜
烤牌子	饮食/2烹饪/2中国烹饪/2八大菜系/苏菜
靠大虾	饮食/2烹饪/2中国烹饪/2八大菜系/苏菜
凉菜卷	饮食/2烹饪/2中国烹饪/2八大菜系/苏菜
卤仔鸡	饮食/2烹饪/2中国烹饪/2八大菜系/苏菜
卤牛肉炒香菜	饮食/2烹饪/2中国烹饪/2八大菜系/苏菜
卤鸭片	饮食/2烹饪/2中国烹饪/2八大菜系/苏菜
料烧鸭	饮食/2烹饪/2中国烹饪/2八大菜系/苏菜
梁溪脆鳝，淮安软兜	饮食/2烹饪/2中国烹饪/2八大菜系/苏菜
涟水鸡糕	饮食/2烹饪/2中国烹饪/2八大菜系/苏菜
溜黄菜	饮食/2烹饪/2中国烹饪/2八大菜系/苏菜
芦姜炒鸡片	饮食/2烹饪/2中国烹饪/2八大菜系/苏菜
萝卜丝蒸羊肉	饮食/2烹饪/2中国烹饪/2八大菜系/苏菜
馏鱼片	饮食/2烹饪/2中国烹饪/2八大菜系/苏菜
鲢鱼头豆腐汤	饮食/2烹饪/2中国烹饪/2八大菜系/苏菜
龙凤腿	饮食/2烹饪/2中国烹饪/2八大菜系/苏菜
龙眼酥肉	饮食/2烹饪/2中国烹饪/2八大菜系/苏菜
龙肝凤脑	饮食/2烹饪/2中国烹饪/2八大菜系/苏菜
龙舟鱼	饮食/2烹饪/2中国烹饪/2八大菜系/苏菜
明炉烤乳猪	饮食/2烹饪/2中国烹饪/2八大菜系/苏菜
母油船鸭	饮食/2烹饪/2中国烹饪/2八大菜系/苏菜
毛峰肉丝	饮食/2烹饪/2中国烹饪/2八大菜系/苏菜
眉炸梅卷	饮食/2烹饪/2中国烹饪/2八大菜系/苏菜
米花鸡丁	饮食/2烹饪/2中国烹饪/2八大菜系/苏菜
美宫山药	饮食/2烹饪/2中国烹饪/2八大菜系/苏菜
蜜饯捶藕	饮食/2烹饪/2中国烹饪/2八大菜系/苏菜
魔芋锅巴蟹	饮食/2烹饪/2中国烹饪/2八大菜系/苏菜
麻花野鸡	饮食/2烹饪/2中国烹饪/2八大菜系/苏菜
密汁火方	饮食/2烹饪/2中国烹饪/2八大菜系/苏菜
牡丹鲈鱼	饮食/2烹饪/2中国烹饪/2八大菜系/苏菜
奶汤元鱼	饮食/2烹饪/2中国烹饪/2八大菜系/苏菜
奶汤蒲菜	饮食/2烹饪/2中国烹饪/2八大菜系/苏菜
奶汤银肺	饮食/2烹饪/2中国烹饪/2八大菜系/苏菜
糯米烧麦	饮食/2烹饪/2中国烹饪/2八大菜系/苏菜
糯米芝麻球	饮食/2烹饪/2中国烹饪/2八大菜系/苏菜
酿杂烩	饮食/2烹饪/2中国烹饪/2八大菜系/苏菜
牛乳鲜鱼唇	饮食/2烹饪/2中国烹饪/2八大菜系/苏菜
藕粉圆子	饮食/2烹饪/2中国烹饪/2八大菜系/苏菜
刨盐黄鱼	饮食/2烹饪/2中国烹饪/2八大菜系/苏菜
品品醋黄河鲤鱼	饮食/2烹饪/2中国烹饪/2八大菜系/苏菜
培根奶油蛋汁	饮食/2烹饪/2中国烹饪/2八大菜系/苏菜
彭城鱼丸	饮食/2烹饪/2中国烹饪/2八大菜系/苏菜
沛公狗肉	饮食/2烹饪/2中国烹饪/2八大菜系/苏菜
泡椒炒血皮菜	饮食/2烹饪/2中国烹饪/2八大菜系/苏菜
苹果红枣炖鲩鱼汤	饮食/2烹饪/2中国烹饪/2八大菜系/苏菜
清汤火方	饮食/2烹饪/2中国烹饪/2八大菜系/苏菜
清炖兔子	饮食/2烹饪/2中国烹饪/2八大菜系/苏菜
清炖狼山鸡	饮食/2烹饪/2中国烹饪/2八大菜系/苏菜
清炖硕鸭	饮食/2烹饪/2中国烹饪/2八大菜系/苏菜
清炖蟹粉狮子头	饮食/2烹饪/2中国烹饪/2八大菜系/苏菜
清炖马蹄鳖	饮食/2烹饪/2中国烹饪/2八大菜系/苏菜
清炖鸡孚	饮食/2烹饪/2中国烹饪/2八大菜系/苏菜
清炸大肠	饮食/2烹饪/2中国烹饪/2八大菜系/苏菜
清炸黄河刀鱼	饮食/2烹饪/2中国烹饪/2八大菜系/苏菜
清烩海参	饮食/2烹饪/2中国烹饪/2八大菜系/苏菜
清烩鲈鱼片	饮食/2烹饪/2中国烹饪/2八大菜系/苏菜
清蒸刀鱼	饮食/2烹饪/2中国烹饪/2八大菜系/苏菜
清蒸鲥鱼	饮食/2烹饪/2中国烹饪/2八大菜系/苏菜
青鱼甩水	饮食/2烹饪/2中国烹饪/2八大菜系/苏菜
人参珠鸡	饮食/2烹饪/2中国烹饪/2八大菜系/苏菜
瓤豆腐	饮食/2烹饪/2中国烹饪/2八大菜系/苏菜
肉丝拉皮	饮食/2烹饪/2中国烹饪/2八大菜系/苏菜
肉脯蛋卷	饮食/2烹饪/2中国烹饪/2八大菜系/苏菜
肉酿生麸	饮食/2烹饪/2中国烹饪/2八大菜系/苏菜
三丝炒鸽松	饮食/2烹饪/2中国烹饪/2八大菜系/苏菜
三套鸭	饮食/2烹饪/2中国烹饪/2八大菜系/苏菜
三椒魔芋啤酒鸡	饮食/2烹饪/2中国烹饪/2八大菜系/苏菜
三色鸡鱼丸	饮食/2烹饪/2中国烹饪/2八大菜系/苏菜
三鲜脱骨鱼	饮食/2烹饪/2中国烹饪/2八大菜系/苏菜
三鲜酿面筋	饮食/2烹饪/2中国烹饪/2八大菜系/苏菜
什果西米露	饮食/2烹饪/2中国烹饪/2八大菜系/苏菜
双色煎鱼	饮食/2烹饪/2中国烹饪/2八大菜系/苏菜
四喜鸭子	饮食/2烹饪/2中国烹饪/2八大菜系/苏菜
宿迁猪头肉	饮食/2烹饪/2中国烹饪/2八大菜系/苏菜
山东海参	饮食/2烹饪/2中国烹饪/2八大菜系/苏菜
山东酥肉	饮食/2烹饪/2中国烹饪/2八大菜系/苏菜
山鸡塌	饮食/2烹饪/2中国烹饪/2八大菜系/苏菜
松子熏肉	饮食/2烹饪/2中国烹饪/2八大菜系/苏菜
松子肉	饮食/2烹饪/2中国烹饪/2八大菜系/苏菜
松子鸡	饮食/2烹饪/2中国烹饪/2八大菜系/苏菜
松子鸭颈	饮食/2烹饪/2中国烹饪/2八大菜系/苏菜
松鼠厥鱼	饮食/2烹饪/2中国烹饪/2八大菜系/苏菜
松鼠桂鱼	饮食/2烹饪/2中国烹饪/2八大菜系/苏菜
松鼠鳜鱼	饮食/2烹饪/2中国烹饪/2八大菜系/苏菜
松鼠黄鱼	饮食/2烹饪/2中国烹饪/2八大菜系/苏菜
水晶肴肉	饮食/2烹饪/2中国烹饪/2八大菜系/苏菜
水晶肴蹄	饮食/2烹饪/2中国烹饪/2八大菜系/苏菜
水晶豆腐	饮食/2烹饪/2中国烹饪/2八大菜系/苏菜
水炒苜蓿虾仁	饮食/2烹饪/2中国烹饪/2八大菜系/苏菜
烧鸭干丝	饮食/2烹饪/2中国烹饪/2八大菜系/苏菜
珊瑚桂鱼	饮食/2烹饪/2中国烹饪/2八大菜系/苏菜
珊瑚金钩	饮食/2烹饪/2中国烹饪/2八大菜系/苏菜
生煎皈鱼	饮食/2烹饪/2中国烹饪/2八大菜系/苏菜
生煎鱼	饮食/2烹饪/2中国烹饪/2八大菜系/苏菜
神仙鸭子	饮食/2烹饪/2中国烹饪/2八大菜系/苏菜
糁--鸡肉糁	饮食/2烹饪/2中国烹饪/2八大菜系/苏菜
素熘鹅皮	饮食/2烹饪/2中国烹饪/2八大菜系/苏菜
素脆鳝	饮食/2烹饪/2中国烹饪/2八大菜系/苏菜
苏州卤鸭	饮食/2烹饪/2中国烹饪/2八大菜系/苏菜
苏式点心	饮食/2烹饪/2中国烹饪/2八大菜系/苏菜
苏式焖肉面	饮食/2烹饪/2中国烹饪/2八大菜系/苏菜
苏式熏鱼	饮食/2烹饪/2中国烹饪/2八大菜系/苏菜
蒜苗乱斩肉	饮食/2烹饪/2中国烹饪/2八大菜系/苏菜
蒜香海蛰	饮食/2烹饪/2中国烹饪/2八大菜系/苏菜
酥桔元	饮食/2烹饪/2中国烹饪/2八大菜系/苏菜
生炝鲜虾	饮食/2烹饪/2中国烹饪/2八大菜系/苏菜
天下第一菜	饮食/2烹饪/2中国烹饪/2八大菜系/苏菜
氽脊脑	饮食/2烹饪/2中国烹饪/2八大菜系/苏菜
氽西施舌	饮食/2烹饪/2中国烹饪/2八大菜系/苏菜
甜烧肉	饮食/2烹饪/2中国烹饪/2八大菜系/苏菜
糖醋鱼花	饮食/2烹饪/2中国烹饪/2八大菜系/苏菜
脱壳鳜鱼	饮食/2烹饪/2中国烹饪/2八大菜系/苏菜
五丁鱼圆	饮食/2烹饪/2中国烹饪/2八大菜系/苏菜
五味干丝	饮食/2烹饪/2中国烹饪/2八大菜系/苏菜
五子蒸鸡	饮食/2烹饪/2中国烹饪/2八大菜系/苏菜
五柳青鱼	饮食/2烹饪/2中国烹饪/2八大菜系/苏菜
五香熏鱼	饮食/2烹饪/2中国烹饪/2八大菜系/苏菜
文思豆腐	饮食/2烹饪/2中国烹饪/2八大菜系/苏菜
无锡排骨	饮食/2烹饪/2中国烹饪/2八大菜系/苏菜
无锡肉排	饮食/2烹饪/2中国烹饪/2八大菜系/苏菜
无锡肉骨头	饮食/2烹饪/2中国烹饪/2八大菜系/苏菜
武溜肉片	饮食/2烹饪/2中国烹饪/2八大菜系/苏菜
网包鳜鱼	饮食/2烹饪/2中国烹饪/2八大菜系/苏菜
咸蛋黄炒南瓜	饮食/2烹饪/2中国烹饪/2八大菜系/苏菜
响铃球	饮食/2烹饪/2中国烹饪/2八大菜系/苏菜
小笼汤包	饮食/2烹饪/2中国烹饪/2八大菜系/苏菜
熏干香蒜炒肉丝	饮食/2烹饪/2中国烹饪/2八大菜系/苏菜
虾仁拉丝蛋	饮食/2烹饪/2中国烹饪/2八大菜系/苏菜
虾仁豆腐羹	饮食/2烹饪/2中国烹饪/2八大菜系/苏菜
蟹粉狮子头	饮食/2烹饪/2中国烹饪/2八大菜系/苏菜
蟹黄汤包	饮食/2烹饪/2中国烹饪/2八大菜系/苏菜
血皮菜蛋花汤	饮食/2烹饪/2中国烹饪/2八大菜系/苏菜
西班牙烘蛋	饮食/2烹饪/2中国烹饪/2八大菜系/苏菜
西瓜鸡	饮食/2烹饪/2中国烹饪/2八大菜系/苏菜
雪丽大蟹	饮食/2烹饪/2中国烹饪/2八大菜系/苏菜
雪丽蛋泊肉	饮食/2烹饪/2中国烹饪/2八大菜系/苏菜
雪花豆腐	饮食/2烹饪/2中国烹饪/2八大菜系/苏菜
香炸云雾	饮食/2烹饪/2中国烹饪/2八大菜系/苏菜
香炸银鱼	饮食/2烹饪/2中国烹饪/2八大菜系/苏菜
香糟竹笋尖	饮食/2烹饪/2中国烹饪/2八大菜系/苏菜
香糟鸡片	饮食/2烹饪/2中国烹饪/2八大菜系/苏菜
香糟鸭舌头	饮食/2烹饪/2中国烹饪/2八大菜系/苏菜
香芋烧竹鸡	饮食/2烹饪/2中国烹饪/2八大菜系/苏菜
香蕉果炸	饮食/2烹饪/2中国烹饪/2八大菜系/苏菜
香辣薯丝	饮食/2烹饪/2中国烹饪/2八大菜系/苏菜
香酥萝卜丸子	饮食/2烹饪/2中国烹饪/2八大菜系/苏菜
蟹子豆腐	饮食/2烹饪/2中国烹饪/2八大菜系/苏菜
一品豆腐	饮食/2烹饪/2中国烹饪/2八大菜系/苏菜
夜来香氽鸡片	饮食/2烹饪/2中国烹饪/2八大菜系/苏菜
扬州干丝	饮食/2烹饪/2中国烹饪/2八大菜系/苏菜
扬州煮干丝	饮食/2烹饪/2中国烹饪/2八大菜系/苏菜
扬州蛋炒饭	饮食/2烹饪/2中国烹饪/2八大菜系/苏菜
扬州酱菜	饮食/2烹饪/2中国烹饪/2八大菜系/苏菜
樱桃肉	饮食/2烹饪/2中国烹饪/2八大菜系/苏菜
油养虾饼	饮食/2烹饪/2中国烹饪/2八大菜系/苏菜
油炸蛎黄	饮食/2烹饪/2中国烹饪/2八大菜系/苏菜
油焐脆皮鸭	饮食/2烹饪/2中国烹饪/2八大菜系/苏菜
油焖烤麸	饮食/2烹饪/2中国烹饪/2八大菜系/苏菜
油爆双脆	饮食/2烹饪/2中国烹饪/2八大菜系/苏菜
油爆河虾	饮食/2烹饪/2中国烹饪/2八大菜系/苏菜
油爆海螺	饮食/2烹饪/2中国烹饪/2八大菜系/苏菜
洋葱爆炒牛肉	饮食/2烹饪/2中国烹饪/2八大菜系/苏菜
玉兔海参	饮食/2烹饪/2中国烹饪/2八大菜系/苏菜
玉米蘑菇小炒	饮食/2烹饪/2中国烹饪/2八大菜系/苏菜
羊方藏鱼	饮食/2烹饪/2中国烹饪/2八大菜系/苏菜
肴肉	饮食/2烹饪/2中国烹饪/2八大菜系/苏菜
诱人香蔬烤鸡腿	饮食/2烹饪/2中国烹饪/2八大菜系/苏菜
野鸭菜饭	饮食/2烹饪/2中国烹饪/2八大菜系/苏菜
银丝长鱼	饮食/2烹饪/2中国烹饪/2八大菜系/苏菜
鱼头豆腐	饮食/2烹饪/2中国烹饪/2八大菜系/苏菜
鱼羊鲜	饮食/2烹饪/2中国烹饪/2八大菜系/苏菜
鱼翅鸡羹	饮食/2烹饪/2中国烹饪/2八大菜系/苏菜
鱼茸蹄筋	饮食/2烹饪/2中国烹饪/2八大菜系/苏菜
鸭包鱼翅	饮食/2烹饪/2中国烹饪/2八大菜系/苏菜
鸳鸯雪花卷	饮食/2烹饪/2中国烹饪/2八大菜系/苏菜
招远蒸丸	饮食/2烹饪/2中国烹饪/2八大菜系/苏菜
朱洪武豆腐	饮食/2烹饪/2中国烹饪/2八大菜系/苏菜
枣方肉	饮食/2烹饪/2中国烹饪/2八大菜系/苏菜
炸 肉 千	饮食/2烹饪/2中国烹饪/2八大菜系/苏菜
炸海蟹	饮食/2烹饪/2中国烹饪/2八大菜系/苏菜
炸菠菜脯	饮食/2烹饪/2中国烹饪/2八大菜系/苏菜
炸鸡扇	饮食/2烹饪/2中国烹饪/2八大菜系/苏菜
炸鸡椒	饮食/2烹饪/2中国烹饪/2八大菜系/苏菜
炸鸡球	饮食/2烹饪/2中国烹饪/2八大菜系/苏菜
煮糟青鱼	饮食/2烹饪/2中国烹饪/2八大菜系/苏菜
猪耳冻	饮食/2烹饪/2中国烹饪/2八大菜系/苏菜
珍珠海参	饮食/2烹饪/2中国烹饪/2八大菜系/苏菜
竹影海参	饮食/2烹饪/2中国烹饪/2八大菜系/苏菜
糟扣肉	饮食/2烹饪/2中国烹饪/2八大菜系/苏菜
紫包滑蛋	饮食/2烹饪/2中国烹饪/2八大菜系/苏菜
纸包三鲜	饮食/2烹饪/2中国烹饪/2八大菜系/苏菜
芝麻条	饮食/2烹饪/2中国烹饪/2八大菜系/苏菜
芝麻薯球	饮食/2烹饪/2中国烹饪/2八大菜系/苏菜
醉蚶	饮食/2烹饪/2中国烹饪/2八大菜系/苏菜
醉蟹	饮食/2烹饪/2中国烹饪/2八大菜系/苏菜
醉蟹清炖鸡	饮食/2烹饪/2中国烹饪/2八大菜系/苏菜
镇江三怪	饮食/2烹饪/2中国烹饪/2八大菜系/苏菜
芝麻海带冬瓜汤	饮食/2烹饪/2中国烹饪/2八大菜系/苏菜
安徽卤舌	饮食/2烹饪/2中国烹饪/2八大菜系/闽菜
腌鲜鳜鱼	饮食/2烹饪/2中国烹饪/2八大菜系/闽菜
八宝葫芦鸡	饮食/2烹饪/2中国烹饪/2八大菜系/闽菜
八宝青蟹饭	饮食/2烹饪/2中国烹饪/2八大菜系/闽菜
八生火锅	饮食/2烹饪/2中国烹饪/2八大菜系/闽菜
包心鱼丸	饮食/2烹饪/2中国烹饪/2八大菜系/闽菜
北芪杞子炖乳鸽	饮食/2烹饪/2中国烹饪/2八大菜系/闽菜
扒海羊	饮食/2烹饪/2中国烹饪/2八大菜系/闽菜
扳指干贝	饮食/2烹饪/2中国烹饪/2八大菜系/闽菜
槟榔芋饼	饮食/2烹饪/2中国烹饪/2八大菜系/闽菜
爆炒羊肚	饮食/2烹饪/2中国烹饪/2八大菜系/闽菜
爆炒鳝片	饮食/2烹饪/2中国烹饪/2八大菜系/闽菜
爆糟排骨	饮食/2烹饪/2中国烹饪/2八大菜系/闽菜
爆鳝片	饮食/2烹饪/2中国烹饪/2八大菜系/闽菜
白拌黄螺	饮食/2烹饪/2中国烹饪/2八大菜系/闽菜
白炒响螺	饮食/2烹饪/2中国烹饪/2八大菜系/闽菜
白烧鱼翅	饮食/2烹饪/2中国烹饪/2八大菜系/闽菜
白焯响螺	饮食/2烹饪/2中国烹饪/2八大菜系/闽菜
白蜜黄螺	饮食/2烹饪/2中国烹饪/2八大菜系/闽菜
碧玉豌豆仁	饮食/2烹饪/2中国烹饪/2八大菜系/闽菜
白鱼汁唇	饮食/2烹饪/2中国烹饪/2八大菜系/闽菜
八珍钱	饮食/2烹饪/2中国烹饪/2八大菜系/闽菜
白灼苦螺	饮食/2烹饪/2中国烹饪/2八大菜系/闽菜
白炒鱿鱼丝	饮食/2烹饪/2中国烹饪/2八大菜系/闽菜
班指干贝	饮食/2烹饪/2中国烹饪/2八大菜系/闽菜
冰糖八果饭	饮食/2烹饪/2中国烹饪/2八大菜系/闽菜
菠萝烧骨排	饮食/2烹饪/2中国烹饪/2八大菜系/闽菜
八宝红鲟饭	饮食/2烹饪/2中国烹饪/2八大菜系/闽菜
爆糟肉	饮食/2烹饪/2中国烹饪/2八大菜系/闽菜
彩色肉丝	饮食/2烹饪/2中国烹饪/2八大菜系/闽菜
擦饼卷	饮食/2烹饪/2中国烹饪/2八大菜系/闽菜
炒海瓜子	饮食/2烹饪/2中国烹饪/2八大菜系/闽菜
炒海蜇	饮食/2烹饪/2中国烹饪/2八大菜系/闽菜
炒米粉	饮食/2烹饪/2中国烹饪/2八大菜系/闽菜
炒芙蓉蟹	饮食/2烹饪/2中国烹饪/2八大菜系/闽菜
炒薯粉片	饮食/2烹饪/2中国烹饪/2八大菜系/闽菜
炒蜇血	饮食/2烹饪/2中国烹饪/2八大菜系/闽菜
炒鲎片	饮食/2烹饪/2中国烹饪/2八大菜系/闽菜
炒鳊鱼冬笋	饮食/2烹饪/2中国烹饪/2八大菜系/闽菜
肠灌肠	饮食/2烹饪/2中国烹饪/2八大菜系/闽菜
茶口粉干	饮食/2烹饪/2中国烹饪/2八大菜系/闽菜
菜包	饮食/2烹饪/2中国烹饪/2八大菜系/闽菜
菜头粿	饮食/2烹饪/2中国烹饪/2八大菜系/闽菜
葱油蒸鸭	饮食/2烹饪/2中国烹饪/2八大菜系/闽菜
葱油饼	饮食/2烹饪/2中国烹饪/2八大菜系/闽菜
葱爆肉丝	饮食/2烹饪/2中国烹饪/2八大菜系/闽菜
蚕豆糟菜炒笋	饮食/2烹饪/2中国烹饪/2八大菜系/闽菜
蛏熘奇	饮食/2烹饪/2中国烹饪/2八大菜系/闽菜
陈皮炸排骨	饮食/2烹饪/2中国烹饪/2八大菜系/闽菜
脆皮蚵卷	饮食/2烹饪/2中国烹饪/2八大菜系/闽菜
葱爆牛肉丝	饮食/2烹饪/2中国烹饪/2八大菜系/闽菜
汆汤发菜鲍鱼	饮食/2烹饪/2中国烹饪/2八大菜系/闽菜
葱段生煎鸡	饮食/2烹饪/2中国烹饪/2八大菜系/闽菜
炒鲨片	饮食/2烹饪/2中国烹饪/2八大菜系/闽菜
葱烧肥鸭	饮食/2烹饪/2中国烹饪/2八大菜系/闽菜
炒沙茶牛肉	饮食/2烹饪/2中国烹饪/2八大菜系/闽菜
炒素虾仁	饮食/2烹饪/2中国烹饪/2八大菜系/闽菜
葱爆羊肉丝	饮食/2烹饪/2中国烹饪/2八大菜系/闽菜
东江盐浸鸡	饮食/2烹饪/2中国烹饪/2八大菜系/闽菜
东璧龙珠	饮食/2烹饪/2中国烹饪/2八大菜系/闽菜
地瓜糖	饮食/2烹饪/2中国烹饪/2八大菜系/闽菜
澹糟香螺片	饮食/2烹饪/2中国烹饪/2八大菜系/闽菜
蛋拌豆腐	饮食/2烹饪/2中国烹饪/2八大菜系/闽菜
豆粽	饮食/2烹饪/2中国烹饪/2八大菜系/闽菜
豆腐卤	饮食/2烹饪/2中国烹饪/2八大菜系/闽菜
豆腐蛎	饮食/2烹饪/2中国烹饪/2八大菜系/闽菜
蛋黄蒸肉	饮食/2烹饪/2中国烹饪/2八大菜系/闽菜
冬菜鸭	饮食/2烹饪/2中国烹饪/2八大菜系/闽菜
蛋菇	饮食/2烹饪/2中国烹饪/2八大菜系/闽菜
淡槽鲜竹蛏	饮食/2烹饪/2中国烹饪/2八大菜系/闽菜
豆干炒菜脯	饮食/2烹饪/2中国烹饪/2八大菜系/闽菜
二冬鲍鱼	饮食/2烹饪/2中国烹饪/2八大菜系/闽菜
佛跳墙	饮食/2烹饪/2中国烹饪/2八大菜系/闽菜
凤尾虾排	饮食/2烹饪/2中国烹饪/2八大菜系/闽菜
福寿全	饮食/2烹饪/2中国烹饪/2八大菜系/闽菜
福州闽菜培训学校	饮食/2烹饪/2中国烹饪/2八大菜系/闽菜
芙蓉干贝	饮食/2烹饪/2中国烹饪/2八大菜系/闽菜
芙蓉海蚌	饮食/2烹饪/2中国烹饪/2八大菜系/闽菜
风炖牡丹	饮食/2烹饪/2中国烹饪/2八大菜系/闽菜
风生火锅	饮食/2烹饪/2中国烹饪/2八大菜系/闽菜
伏龙肝烤嫩鸡	饮食/2烹饪/2中国烹饪/2八大菜系/闽菜
风味煎糯藕	饮食/2烹饪/2中国烹饪/2八大菜系/闽菜
干烧牛肉片	饮食/2烹饪/2中国烹饪/2八大菜系/闽菜
干烧虾	饮食/2烹饪/2中国烹饪/2八大菜系/闽菜
干烧鱼	饮食/2烹饪/2中国烹饪/2八大菜系/闽菜
干贝水晶鸡	饮食/2烹饪/2中国烹饪/2八大菜系/闽菜
干贝水晶鸡3	饮食/2烹饪/2中国烹饪/2八大菜系/闽菜
桂花梭子蟹	饮食/2烹饪/2中国烹饪/2八大菜系/闽菜
橄榄菜豆豉蒸鱼	饮食/2烹饪/2中国烹饪/2八大菜系/闽菜
蛤仔猪肚汤	饮食/2烹饪/2中国烹饪/2八大菜系/闽菜
蛤蜊鲫鱼	饮食/2烹饪/2中国烹饪/2八大菜系/闽菜
鼓椒鸡丁	饮食/2烹饪/2中国烹饪/2八大菜系/闽菜
挂炉鸭	饮食/2烹饪/2中国烹饪/2八大菜系/闽菜
过烧鸭	饮食/2烹饪/2中国烹饪/2八大菜系/闽菜
干贝萝卜珠	饮食/2烹饪/2中国烹饪/2八大菜系/闽菜
瓜烧白菜	饮食/2烹饪/2中国烹饪/2八大菜系/闽菜
枸枳鳖裙	饮食/2烹饪/2中国烹饪/2八大菜系/闽菜
干炸龙凤腿	饮食/2烹饪/2中国烹饪/2八大菜系/闽菜
干蒸猪肉	饮食/2烹饪/2中国烹饪/2八大菜系/闽菜
合菜盖被	饮食/2烹饪/2中国烹饪/2八大菜系/闽菜
汉鸭	饮食/2烹饪/2中国烹饪/2八大菜系/闽菜
海参羹	饮食/2烹饪/2中国烹饪/2八大菜系/闽菜
海鲜豆腐羹	饮食/2烹饪/2中国烹饪/2八大菜系/闽菜
火腿炖甲鱼	饮食/2烹饪/2中国烹饪/2八大菜系/闽菜
火龙果小仔排	饮食/2烹饪/2中国烹饪/2八大菜系/闽菜
烩蹄筋	饮食/2烹饪/2中国烹饪/2八大菜系/闽菜
红焖通心河鳗	饮食/2烹饪/2中国烹饪/2八大菜系/闽菜
红豆沙包	饮食/2烹饪/2中国烹饪/2八大菜系/闽菜
花卷鱿鱼	饮食/2烹饪/2中国烹饪/2八大菜系/闽菜
花瓜竹笙鸡汤	饮食/2烹饪/2中国烹饪/2八大菜系/闽菜
花生粉团汤	饮食/2烹饪/2中国烹饪/2八大菜系/闽菜
花芋烧猪蹄	饮食/2烹饪/2中国烹饪/2八大菜系/闽菜
荤罗汉	饮食/2烹饪/2中国烹饪/2八大菜系/闽菜
荷叶蒸饭	饮食/2烹饪/2中国烹饪/2八大菜系/闽菜
韩式炒白粿	饮食/2烹饪/2中国烹饪/2八大菜系/闽菜
馄饨鸭子	饮食/2烹饪/2中国烹饪/2八大菜系/闽菜
鲎羹	饮食/2烹饪/2中国烹饪/2八大菜系/闽菜
鸿图鸭	饮食/2烹饪/2中国烹饪/2八大菜系/闽菜
黄尖笋	饮食/2烹饪/2中国烹饪/2八大菜系/闽菜
黄山炖鸽	饮食/2烹饪/2中国烹饪/2八大菜系/闽菜
黑椒糟香鸡块	饮食/2烹饪/2中国烹饪/2八大菜系/闽菜
海蛎烧豆腐	饮食/2烹饪/2中国烹饪/2八大菜系/闽菜
黄金玉蚌	饮食/2烹饪/2中国烹饪/2八大菜系/闽菜
红煨猪排	饮食/2烹饪/2中国烹饪/2八大菜系/闽菜
红糟鸡丁	饮食/2烹饪/2中国烹饪/2八大菜系/闽菜
花菇玉兰片	饮食/2烹饪/2中国烹饪/2八大菜系/闽菜
荷包鱼翅	饮食/2烹饪/2中国烹饪/2八大菜系/闽菜
红烧金钱鲍	饮食/2烹饪/2中国烹饪/2八大菜系/闽菜
红烧荷包鱼翅	饮食/2烹饪/2中国烹饪/2八大菜系/闽菜
海鲜酿苦瓜	饮食/2烹饪/2中国烹饪/2八大菜系/闽菜
荷叶粉肉卷	饮食/2烹饪/2中国烹饪/2八大菜系/闽菜
九层粿	饮食/2烹饪/2中国烹饪/2八大菜系/闽菜
吉利虾	饮食/2烹饪/2中国烹饪/2八大菜系/闽菜
夹心虾糕	饮食/2烹饪/2中国烹饪/2八大菜系/闽菜
家乡肉	饮食/2烹饪/2中国烹饪/2八大菜系/闽菜
家常佛跳墙	饮食/2烹饪/2中国烹饪/2八大菜系/闽菜
家常烤鸡	饮食/2烹饪/2中国烹饪/2八大菜系/闽菜
桔烧巴	饮食/2烹饪/2中国烹饪/2八大菜系/闽菜
桔烧鳗	饮食/2烹饪/2中国烹饪/2八大菜系/闽菜
椒盐肚尖	饮食/2烹饪/2中国烹饪/2八大菜系/闽菜
江南丸	饮食/2烹饪/2中国烹饪/2八大菜系/闽菜
焦麻螺蛳	饮食/2烹饪/2中国烹饪/2八大菜系/闽菜
煎明虾段	饮食/2烹饪/2中国烹饪/2八大菜系/闽菜
碱芋茸	饮食/2烹饪/2中国烹饪/2八大菜系/闽菜
粳粽	饮食/2烹饪/2中国烹饪/2八大菜系/闽菜
继光饼	饮食/2烹饪/2中国烹饪/2八大菜系/闽菜
荠菜元子	饮食/2烹饪/2中国烹饪/2八大菜系/闽菜
菊花鲈鱼	饮食/2烹饪/2中国烹饪/2八大菜系/闽菜
金钱干贝	饮食/2烹饪/2中国烹饪/2八大菜系/闽菜
金钱肉	饮食/2烹饪/2中国烹饪/2八大菜系/闽菜
金银蹄鸡	饮食/2烹饪/2中国烹饪/2八大菜系/闽菜
金雀舌	饮食/2烹饪/2中国烹饪/2八大菜系/闽菜
金鱼戏莲	饮食/2烹饪/2中国烹饪/2八大菜系/闽菜
韭菜盒	饮食/2烹饪/2中国烹饪/2八大菜系/闽菜
鸡丝燕窝	饮食/2烹饪/2中国烹饪/2八大菜系/闽菜
鸡卷	饮食/2烹饪/2中国烹饪/2八大菜系/闽菜
鸡汤伊面	饮食/2烹饪/2中国烹饪/2八大菜系/闽菜
鸡汤氽海蚌	饮食/2烹饪/2中国烹饪/2八大菜系/闽菜
江东鲈鱼炖姜丝	饮食/2烹饪/2中国烹饪/2八大菜系/闽菜
椒盐凤尾虾	饮食/2烹饪/2中国烹饪/2八大菜系/闽菜
加鱼头白菜煲	饮食/2烹饪/2中国烹饪/2八大菜系/闽菜
九肠	饮食/2烹饪/2中国烹饪/2八大菜系/闽菜
咖哩牛肉	饮食/2烹饪/2中国烹饪/2八大菜系/闽菜
咖哩鸡	饮食/2烹饪/2中国烹饪/2八大菜系/闽菜
扛糟羊肉	饮食/2烹饪/2中国烹饪/2八大菜系/闽菜
扛糟鸡	饮食/2烹饪/2中国烹饪/2八大菜系/闽菜
捆蹄	饮食/2烹饪/2中国烹饪/2八大菜系/闽菜
苦中作乐	饮食/2烹饪/2中国烹饪/2八大菜系/闽菜
苦菜大肠汤	饮食/2烹饪/2中国烹饪/2八大菜系/闽菜
卤豆腐	饮食/2烹饪/2中国烹饪/2八大菜系/闽菜
拉糟鱼块	饮食/2烹饪/2中国烹饪/2八大菜系/闽菜
李鸿章杂烩	饮食/2烹饪/2中国烹饪/2八大菜系/闽菜
溜鸽松	饮食/2烹饪/2中国烹饪/2八大菜系/闽菜
灵芝恋玉蝉	饮食/2烹饪/2中国烹饪/2八大菜系/闽菜
熘炸仔鸡	饮食/2烹饪/2中国烹饪/2八大菜系/闽菜
熘鸽松	饮食/2烹饪/2中国烹饪/2八大菜系/闽菜
绿茶蒜香排骨	饮食/2烹饪/2中国烹饪/2八大菜系/闽菜
罗汉鱼首	饮食/2烹饪/2中国烹饪/2八大菜系/闽菜
罗汉鸭	饮食/2烹饪/2中国烹饪/2八大菜系/闽菜
腊兔肉	饮食/2烹饪/2中国烹饪/2八大菜系/闽菜
芦笋干贝羹	饮食/2烹饪/2中国烹饪/2八大菜系/闽菜
莲子鸡丁	饮食/2烹饪/2中国烹饪/2八大菜系/闽菜
莲美豆干	饮食/2烹饪/2中国烹饪/2八大菜系/闽菜
莲蓬鱼	饮食/2烹饪/2中国烹饪/2八大菜系/闽菜
辣酱面	饮食/2烹饪/2中国烹饪/2八大菜系/闽菜
龙凤腿	饮食/2烹饪/2中国烹饪/2八大菜系/闽菜
龙身凤尾虾	饮食/2烹饪/2中国烹饪/2八大菜系/闽菜
龙须燕丸	饮食/2烹饪/2中国烹饪/2八大菜系/闽菜
凉拌鹅肉	饮食/2烹饪/2中国烹饪/2八大菜系/闽菜
萝卜蜇丝	饮食/2烹饪/2中国烹饪/2八大菜系/闽菜
莲藕冬瓜瘦肉扁豆汤	饮食/2烹饪/2中国烹饪/2八大菜系/闽菜
木瓜烩鱼肚	饮食/2烹饪/2中国烹饪/2八大菜系/闽菜
玟瑰大虾	饮食/2烹饪/2中国烹饪/2八大菜系/闽菜
米糖	饮食/2烹饪/2中国烹饪/2八大菜系/闽菜
蜜汁红芋	饮食/2烹饪/2中国烹饪/2八大菜系/闽菜
闽南煎包	饮食/2烹饪/2中国烹饪/2八大菜系/闽菜
闽味清蒸鲈鱼	饮食/2烹饪/2中国烹饪/2八大菜系/闽菜
闽味焖煮火腿白菜	饮食/2烹饪/2中国烹饪/2八大菜系/闽菜
闽生果	饮食/2烹饪/2中国烹饪/2八大菜系/闽菜
面线糊	饮食/2烹饪/2中国烹饪/2八大菜系/闽菜
马蹄鸡丁	饮食/2烹饪/2中国烹饪/2八大菜系/闽菜
马鲛粳	饮食/2烹饪/2中国烹饪/2八大菜系/闽菜
魔芋糕	饮食/2烹饪/2中国烹饪/2八大菜系/闽菜
美极基围虾	饮食/2烹饪/2中国烹饪/2八大菜系/闽菜
闽醉排骨	饮食/2烹饪/2中国烹饪/2八大菜系/闽菜
墨鱼炒韭菜花	饮食/2烹饪/2中国烹饪/2八大菜系/闽菜
南煎肝	饮食/2烹饪/2中国烹饪/2八大菜系/闽菜
奶汁肥王鱼	饮食/2烹饪/2中国烹饪/2八大菜系/闽菜
奶汤草腹	饮食/2烹饪/2中国烹饪/2八大菜系/闽菜
嫩饼	饮食/2烹饪/2中国烹饪/2八大菜系/闽菜
牛筋煲	饮食/2烹饪/2中国烹饪/2八大菜系/闽菜
牛肉炕块	饮食/2烹饪/2中国